"","GISJOIN_T","whites","blacks","asians","native_americans","others","latino","tot"
"1","G26016305001",3702,64,41,14,4,57,3882
"2","G26016305002",2672,288,48,18,0,28,3054
"3","G26016305003",2818,850,64,28,10,55,3825
"4","G26016305004",991,4580,32,12,2,27,5644
"5","G26016305005",747,3381,79,15,11,42,4275
"6","G26016305006",2462,4196,57,41,11,73,6840
"7","G26016305007",3445,628,45,19,5,60,4202
"8","G26016305008",2197,166,22,5,0,62,2452
"9","G26016305009",2366,1524,55,14,3,38,4000
"10","G26016305010",1333,2221,47,5,3,40,3649
"11","G26016305011",763,4257,33,19,14,38,5124
"12","G26016305012",821,2057,5,17,5,17,2922
"13","G26016305013",858,4503,24,31,3,54,5473
"14","G26016305014",2084,2045,42,20,3,55,4249
"15","G26016305015",3610,327,70,15,2,36,4060
"16","G26016305016",1900,82,13,3,0,25,2023
"17","G26016305017",2456,131,14,14,0,57,2672
"18","G26016305018",3425,1388,63,6,11,51,4944
"19","G26016305019",1244,2335,29,12,7,36,3663
"20","G26016305020",567,3494,5,3,12,31,4112
"21","G26016305031",1976,854,38,6,0,37,2911
"22","G26016305032",3289,754,56,8,3,70,4180
"23","G26016305033",2303,2359,189,16,12,43,4922
"24","G26016305034",1259,723,395,10,15,43,2445
"25","G26016305035",1659,3788,240,12,7,95,5801
"26","G26016305036",691,2220,296,14,19,48,3288
"27","G26016305037",584,2480,444,7,6,41,3562
"28","G26016305039",383,4169,15,9,2,41,4619
"29","G26016305040",272,2618,24,7,0,14,2935
"30","G26016305041",418,2955,14,3,4,27,3421
"31","G26016305042",240,4452,4,2,4,25,4727
"32","G26016305043",329,4277,5,6,1,12,4630
"33","G26016305044",246,4253,9,9,1,29,4547
"34","G26016305045",279,872,1,7,0,6,1165
"35","G26016305046",57,2002,0,3,2,20,2084
"36","G26016305047",102,4577,3,9,3,17,4711
"37","G26016305048",249,2623,7,8,3,13,2903
"38","G26016305049",806,3154,8,10,5,30,4013
"39","G26016305050",603,1453,13,3,7,11,2090
"40","G26016305051",1213,2692,19,8,4,42,3978
"41","G26016305052",564,4204,17,28,0,11,4824
"42","G26016305053",283,3170,9,13,6,12,3493
"43","G26016305061",926,1149,45,12,2,17,2151
"44","G26016305062",586,2014,16,10,8,34,2668
"45","G26016305063",731,2789,58,15,4,33,3630
"46","G26016305064",594,1832,2,2,1,9,2440
"47","G26016305065",337,2978,2,4,2,32,3355
"48","G26016305066",609,3742,1,13,1,20,4386
"49","G26016305067",522,1051,9,4,2,6,1594
"50","G26016305068",963,3629,22,4,5,42,4665
"51","G26016305069",748,4356,14,7,3,27,5155
"52","G26016305070",44,3241,5,4,8,19,3321
"53","G26016305071",69,3439,7,0,5,22,3542
"54","G26016305072",64,2343,0,4,6,14,2431
"55","G26016305073",176,4453,8,18,8,35,4698
"56","G26016305074",228,4010,7,8,0,19,4272
"57","G26016305075",394,3078,16,4,3,35,3530
"58","G26016305076",965,2206,19,17,12,54,3273
"59","G26016305077",126,1896,40,5,0,28,2095
"60","G26016305078",473,1864,7,11,5,34,2394
"61","G26016305079",2865,2562,96,20,17,114,5674
"62","G26016305080",1935,1554,115,23,7,110,3744
"63","G26016305102",962,2069,14,10,1,51,3107
"64","G26016305103",537,1485,22,5,9,15,2073
"65","G26016305104",146,2944,4,1,4,9,3108
"66","G26016305105",1853,2351,327,18,4,56,4609
"67","G26016305106",2662,1553,47,6,1,54,4323
"68","G26016305107",815,1095,183,13,1,25,2132
"69","G26016305108",295,2183,4,10,0,9,2501
"70","G26016305109",149,2750,5,4,0,14,2922
"71","G26016305111",2,243,0,0,0,2,247
"72","G26016305112",3,848,0,0,0,0,851
"73","G26016305113",23,1966,1,4,2,9,2005
"74","G26016305114",31,1004,0,2,1,3,1041
"75","G26016305115",32,1370,4,5,5,15,1431
"76","G26016305116",73,3989,6,19,12,29,4128
"77","G26016305117",13,1079,0,0,0,17,1109
"78","G26016305121",257,5536,3,10,2,10,5818
"79","G26016305122",117,1594,2,3,0,18,1734
"80","G26016305123",129,2704,13,8,2,9,2865
"81","G26016305124",158,3564,2,15,5,7,3751
"82","G26016305126",230,4303,3,4,2,16,4558
"83","G26016305129",379,3452,3,10,3,30,3877
"84","G26016305132",657,3163,20,3,6,37,3886
"85","G26016305133",677,1638,22,6,6,17,2366
"86","G26016305134",47,2967,1,7,0,16,3038
"87","G26016305135",241,881,10,5,0,21,1158
"88","G26016305136",287,3170,2,4,3,10,3476
"89","G26016305139",44,4910,2,5,0,5,4966
"90","G26016305140",2,71,0,0,0,0,73
"91","G26016305141",68,5994,3,3,6,7,6081
"92","G26016305142",71,397,1,5,0,1,475
"93","G26016305143",60,5147,3,1,1,15,5227
"94","G26016305145",9,2070,0,3,1,4,2087
"95","G26016305146",10,2062,0,1,0,7,2080
"96","G26016305147",14,2234,1,5,3,14,2271
"97","G26016305148",45,1689,1,2,0,19,1756
"98","G26016305149",27,2380,1,6,0,16,2430
"99","G26016305150",29,2870,3,11,0,10,2923
"100","G26016305151",56,2603,1,1,0,3,2664
"101","G26016305152",356,3607,10,10,5,13,4001
"102","G26016305153",592,2891,9,10,4,14,3520
"103","G26016305154",712,969,25,4,7,11,1728
"104","G26016305155",11,1181,0,1,0,20,1213
"105","G26016305156",119,1601,1,1,13,19,1754
"106","G26016305157",1621,1988,37,7,0,58,3711
"107","G26016305161",72,2161,5,1,0,13,2252
"108","G26016305162",100,1414,1,3,0,6,1524
"109","G26016305163",146,1713,3,12,0,10,1884
"110","G26016305164",249,1609,1,1,2,7,1869
"111","G26016305165",200,366,58,3,4,5,636
"112","G2601630516599",26,0,0,0,0,0,26
"113","G26016305166",26,2375,1,1,0,14,2417
"114","G26016305167",45,1681,3,11,1,21,1762
"115","G26016305168",33,2409,3,3,0,3,2451
"116","G26016305169",276,1854,8,6,2,12,2158
"117","G26016305170",821,1198,37,8,9,42,2115
"118","G26016305171",381,1020,15,2,7,27,1452
"119","G26016305172",516,1884,15,4,0,34,2453
"120","G26016305173",170,457,2,5,0,12,646
"121","G26016305174",147,807,14,4,0,8,980
"122","G26016305175",472,2529,177,5,2,25,3210
"123","G26016305176",6,1067,0,0,1,8,1082
"124","G26016305177",27,34,0,0,0,1,62
"125","G26016305178",36,1628,1,9,1,6,1681
"126","G26016305180",417,1342,49,6,4,26,1844
"127","G26016305181",45,408,1,0,0,0,454
"128","G26016305183",209,530,1,2,1,2,745
"129","G26016305184",549,1240,30,9,10,23,1861
"130","G26016305185",681,2514,23,6,3,19,3246
"131","G26016305186",44,2039,0,3,3,6,2095
"132","G26016305187",41,1404,4,2,1,7,1459
"133","G26016305188",52,1347,1,0,0,23,1423
"134","G26016305201",98,47,1,1,3,5,155
"135","G26016305202",916,272,656,29,8,66,1947
"136","G26016305203",548,1157,166,7,2,12,1892
"137","G26016305204",589,882,185,6,1,19,1682
"138","G26016305205",80,776,3,8,0,8,875
"139","G26016305206",1143,1852,86,32,0,67,3180
"140","G26016305207",611,1446,5,14,2,35,2113
"141","G26016305208",390,346,9,2,0,11,758
"142","G26016305209",20,20,0,0,0,22,62
"143","G26016305211",200,408,0,22,6,379,1015
"144","G26016305212",425,219,7,32,4,957,1644
"145","G26016305213",153,931,1,13,0,116,1214
"146","G26016305214",629,434,11,2,5,384,1465
"147","G26016305215",1058,1637,3,29,6,203,2936
"148","G26016305218",17,1294,1,8,3,3,1326
"149","G26016305219",655,2251,22,21,10,41,3000
"150","G26016305220",108,1760,5,19,0,29,1921
"151","G26016305221",41,2355,0,2,2,12,2412
"152","G26016305222",67,1555,3,1,0,2,1628
"153","G26016305223",40,3547,6,17,4,12,3626
"154","G26016305224",172,1849,38,11,4,51,2125
"155","G26016305231",967,345,5,29,1,519,1866
"156","G26016305232",2071,219,66,32,9,2104,4501
"157","G26016305233",1497,273,62,27,8,2192,4059
"158","G26016305234",1180,568,14,52,14,1252,3080
"159","G26016305235",608,537,7,22,0,162,1336
"160","G26016305236",461,1006,3,12,10,155,1647
"161","G26016305237",1606,597,11,20,4,367,2605
"162","G26016305238",3358,349,23,71,21,1658,5480
"163","G26016305240",2005,56,22,43,7,940,3073
"164","G26016305241",2804,79,21,96,5,1228,4233
"165","G26016305242",3693,83,40,48,27,1592,5483
"166","G26016305243",2460,99,2,34,12,677,3284
"167","G26016305245",1164,216,17,9,0,195,1601
"168","G2601630524599",1,0,0,0,0,0,1
"169","G26016305247",75,5917,8,13,2,42,6057
"170","G26016305248",37,3906,2,8,3,19,3975
"171","G26016305251",15,2333,1,5,2,15,2371
"172","G26016305252",13,2330,0,0,2,7,2352
"173","G26016305253",28,1281,1,4,0,10,1324
"174","G26016305254",763,2560,15,13,4,281,3636
"175","G26016305255",455,1653,14,8,1,342,2473
"176","G26016305256",1338,142,61,17,6,400,1964
"177","G26016305257",3418,177,37,37,6,871,4546
"178","G26016305258",1528,166,10,33,5,397,2139
"179","G26016305260",2182,304,9,26,21,623,3165
"180","G26016305261",2115,66,3,12,0,315,2511
"181","G26016305262",2332,424,4,10,10,461,3241
"182","G26016305263",2665,728,42,27,5,936,4403
"183","G26016305264",672,1058,0,15,18,462,2225
"184","G26016305265",66,3920,4,8,13,27,4038
"185","G26016305301",50,4529,4,9,1,20,4613
"186","G26016305302",122,4675,50,10,3,22,4882
"187","G26016305303",51,3199,0,14,4,14,3282
"188","G26016305304",18,2232,1,4,3,11,2269
"189","G26016305305",16,2966,5,5,0,10,3002
"190","G26016305307",49,3924,1,3,0,24,4001
"191","G26016305308",72,4244,0,3,0,11,4330
"192","G26016305310",5,2087,11,2,3,3,2111
"193","G26016305311",72,2712,12,2,1,11,2810
"194","G26016305312",76,3543,4,5,3,26,3657
"195","G26016305313",26,2205,3,2,1,3,2240
"196","G26016305314",11,2700,1,6,0,7,2725
"197","G26016305315",35,5051,4,18,0,15,5123
"198","G26016305316",28,2755,2,2,1,8,2796
"199","G26016305317",30,3146,0,2,2,6,3186
"200","G26016305318",27,4252,4,6,3,17,4309
"201","G26016305319",75,2540,4,2,0,3,2624
"202","G26016305322",81,2737,1,7,8,3,2837
"203","G26016305323",268,1275,5,12,1,8,1569
"204","G26016305324",102,2348,4,5,1,10,2470
"205","G26016305325",371,2301,24,10,5,23,2734
"206","G26016305326",170,2318,81,17,43,63,2692
"207","G26016305327",45,2221,5,5,0,20,2296
"208","G26016305330",131,2437,7,0,0,19,2594
"209","G26016305331",12,2783,0,5,1,20,2821
"210","G26016305332",15,3400,3,5,0,5,3428
"211","G26016305333",43,3840,0,10,0,10,3903
"212","G26016305334",34,5400,5,5,21,36,5501
"213","G26016305335",25,2285,0,5,0,8,2323
"214","G26016305336",38,4358,9,3,3,28,4439
"215","G26016305337",21,2250,2,7,0,7,2287
"216","G26016305341",25,3267,7,3,3,9,3314
"217","G26016305342",80,6411,2,15,7,24,6539
"218","G26016305343",63,2859,3,3,15,12,2955
"219","G26016305344",43,3424,1,3,5,9,3485
"220","G26016305345",30,2112,2,7,0,7,2158
"221","G26016305346",41,3346,0,0,2,16,3405
"222","G26016305347",112,3833,1,3,1,13,3963
"223","G26016305350",218,3993,12,9,7,37,4276
"224","G26016305351",136,2953,0,4,6,24,3123
"225","G26016305352",97,3842,2,6,3,15,3965
"226","G26016305353",229,4951,7,8,4,27,5226
"227","G26016305354",96,2140,3,6,4,23,2272
"228","G26016305355",310,3195,7,10,0,44,3566
"229","G26016305356",339,3798,14,6,2,27,4186
"230","G26016305357",37,2080,3,10,0,22,2152
"231","G26016305361",163,5201,15,18,7,13,5417
"232","G26016305362",32,2317,1,6,2,12,2370
"233","G26016305363",41,5074,12,6,0,32,5165
"234","G26016305364",44,5003,5,6,0,18,5076
"235","G26016305365",33,3175,3,13,1,9,3234
"236","G26016305366",62,5038,1,7,2,13,5123
"237","G26016305367",27,1917,0,2,0,3,1949
"238","G26016305368",20,2338,2,3,1,6,2370
"239","G26016305369",79,4231,3,10,5,27,4355
"240","G26016305370",122,5093,2,7,1,33,5258
"241","G26016305371",59,3152,0,0,1,21,3233
"242","G26016305372",80,1904,0,11,5,14,2014
"243","G26016305373",173,5088,6,28,3,27,5325
"244","G26016305375",102,3983,5,7,0,10,4107
"245","G26016305376",129,4148,12,3,4,28,4324
"246","G26016305377",94,4458,7,9,0,38,4606
"247","G26016305378",99,3400,2,5,0,3,3509
"248","G26016305381",556,1909,14,4,7,39,2529
"249","G26016305382",417,1924,17,3,8,24,2393
"250","G26016305383",412,2601,18,8,1,41,3081
"251","G26016305384",693,3378,81,8,19,55,4234
"252","G26016305385",58,6409,6,11,17,13,6514
"253","G26016305386",93,5628,17,14,0,46,5798
"254","G26016305387",95,4379,2,4,3,21,4504
"255","G26016305388",31,1746,1,3,5,10,1796
"256","G26016305389",95,3835,4,6,0,28,3968
"257","G26016305390",20,3722,0,12,0,21,3775
"258","G26016305391",12,2248,1,5,7,15,2288
"259","G26016305392",120,5456,4,8,1,24,5613
"260","G26016305393",108,4279,12,8,4,19,4430
"261","G26016305394",87,4103,7,4,3,25,4229
"262","G26016305395",407,3333,23,7,1,39,3810
"263","G26016305396",83,3737,8,4,4,29,3865
"264","G26016305397",97,2274,2,4,0,11,2388
"265","G26016305401",220,4189,7,12,1,18,4447
"266","G26016305402",236,4987,11,14,3,32,5283
"267","G26016305403",219,4622,12,3,1,18,4875
"268","G26016305404",297,3729,68,5,11,23,4133
"269","G26016305405",404,3891,8,6,5,31,4345
"270","G26016305406",300,4096,4,3,3,25,4431
"271","G26016305407",746,4048,9,19,8,31,4861
"272","G26016305408",233,2668,22,6,0,16,2945
"273","G26016305409",348,3989,15,9,5,22,4388
"274","G26016305410",384,4576,37,8,11,20,5036
"275","G26016305411",660,5177,8,24,10,33,5912
"276","G26016305412",1025,2446,21,18,8,34,3552
"277","G26016305413",2379,310,37,13,2,51,2792
"278","G26016305414",1892,1123,53,8,4,89,3169
"279","G26016305415",622,3915,50,23,3,23,4636
"280","G26016305417",327,2020,32,13,4,14,2410
"281","G26016305418",1944,826,53,11,2,51,2887
"282","G26016305421",249,5125,9,6,5,19,5413
"283","G26016305422",216,4738,11,7,8,21,5001
"284","G26016305423",173,2910,3,2,1,16,3105
"285","G26016305424",170,3454,0,6,12,17,3659
"286","G26016305425",414,2735,7,13,12,13,3194
"287","G26016305426",128,3993,10,10,3,8,4152
"288","G26016305427",163,1426,5,4,4,3,1605
"289","G26016305428",306,2842,16,5,3,23,3195
"290","G26016305429",918,2917,19,15,12,27,3908
"291","G26016305430",755,1457,11,1,6,23,2253
"292","G26016305431",844,2110,68,4,3,28,3057
"293","G26016305432",608,2958,9,7,9,45,3636
"294","G26016305434",506,3374,5,12,8,31,3936
"295","G26016305435",861,2424,16,30,11,59,3401
"296","G26016305436",1803,2336,10,39,2,67,4257
"297","G26016305437",952,3164,28,9,3,41,4197
"298","G26016305438",1471,1172,7,17,13,41,2721
"299","G26016305439",970,1023,3,12,0,42,2050
"300","G26016305440",1491,899,204,25,1,63,2683
"301","G26016305441",884,1884,45,11,8,29,2861
"302","G26016305442",2697,1144,41,35,5,55,3977
"303","G26016305443",2857,597,35,17,4,62,3572
"304","G26016305451",226,3162,3,1,1,11,3404
"305","G26016305452",276,5178,19,5,2,29,5509
"306","G26016305453",360,3560,3,7,9,23,3962
"307","G26016305454",238,2686,1,12,0,25,2962
"308","G26016305455",2589,1714,24,15,12,168,4522
"309","G26016305456",3809,155,31,13,1,211,4220
"310","G26016305457",2432,28,30,18,1,136,2645
"311","G26016305458",4509,51,42,39,3,177,4821
"312","G26016305459",3596,484,43,24,4,200,4351
"313","G26016305460",1826,2879,22,10,8,119,4864
"314","G26016305461",3230,1287,64,30,0,209,4820
"315","G26016305462",3105,6,32,6,0,81,3230
"316","G26016305463",1221,573,62,16,3,33,1908
"317","G26016305464",426,1353,8,4,1,23,1815
"318","G26016305465",493,2136,8,3,6,27,2673
"319","G26016305466",766,2000,14,11,7,37,2835
"320","G26016305467",591,3435,5,3,6,48,4088
"321","G26016305468",523,4078,7,7,2,37,4654
"322","G26016305469",113,1698,5,6,0,17,1839
"323","G26016305501",4083,42,61,8,2,56,4252
"324","G26016305502",4441,60,85,25,1,101,4713
"325","G26016305503",3816,6,29,3,0,28,3882
"326","G26016305504",1678,13,15,4,0,23,1733
"327","G26016305505",3855,10,38,4,1,40,3948
"328","G26016305506",2592,12,16,2,0,23,2645
"329","G26016305507",5586,10,44,5,0,45,5690
"330","G26016305508",1728,1,24,0,0,4,1757
"331","G26016305509",2687,11,107,3,1,41,2850
"332","G26016305510",7940,4,184,1,0,51,8180
"333","G26016305511",5195,10,42,5,0,28,5280
"334","G26016305512",4221,0,29,2,0,45,4297
"335","G26016305513",3934,9,16,9,0,51,4019
"336","G26016305514",4219,114,75,10,1,40,4459
"337","G26016305515",2441,4,22,0,1,26,2494
"338","G26016305516",3827,4,15,8,0,35,3889
"339","G26016305520",2305,81,16,12,0,27,2441
"340","G26016305521",3209,803,52,31,4,89,4188
"341","G26016305522",2862,175,28,1,0,50,3116
"342","G26016305523",2562,198,54,25,17,54,2910
"343","G26016305524",1291,816,21,4,3,20,2155
"344","G26016305525",1466,73,11,6,0,10,1566
"345","G26016305526",1478,427,38,11,0,42,1996
"346","G26016305530",240,1478,17,9,5,6,1755
"347","G26016305531",289,2905,12,5,8,23,3242
"348","G26016305532",53,2063,8,3,2,10,2139
"349","G26016305533",28,2192,0,0,0,7,2227
"350","G26016305534",127,2063,0,4,3,31,2228
"351","G26016305535",40,1840,2,6,7,23,1918
"352","G26016305536",337,3331,6,1,7,16,3698
"353","G26016305537",157,2722,5,5,4,21,2914
"354","G26016305541",4639,24,36,19,0,64,4782
"355","G26016305542",3623,3,13,23,1,44,3707
"356","G26016305543",5928,5,33,28,1,90,6085
"357","G26016305544",3840,8,13,21,1,41,3924
"358","G26016305545",3262,20,23,14,2,42,3363
"359","G26016305546",4363,39,11,21,0,68,4502
"360","G26016305547",2733,5,12,5,0,35,2790
"361","G26016305548",3601,33,34,13,5,75,3761
"362","G26016305549",1832,11,20,4,0,31,1898
"363","G26016305550",1724,1,3,1,0,17,1746
"364","G26016305551",1633,1,7,3,0,36,1680
"365","G26016305552",3414,2,2,15,2,63,3498
"366","G26016305553",3470,5,21,9,0,85,3590
"367","G26016305554",2738,196,24,12,0,54,3024
"368","G26016305555",3005,6,19,8,0,48,3086
"369","G26016305556",2890,3,18,1,3,36,2951
"370","G26016305560",2165,4,16,9,0,31,2225
"371","G26016305561",1613,0,31,5,0,8,1657
"372","G26016305562",2557,16,28,7,0,31,2639
"373","G26016305563",2649,9,21,7,0,48,2734
"374","G26016305564",4000,53,144,4,1,87,4289
"375","G26016305565",1580,0,11,2,0,22,1615
"376","G26016305566",3400,2,28,4,0,51,3485
"377","G26016305567",2684,7,84,6,1,14,2796
"378","G26016305568",1941,10,27,0,1,35,2014
"379","G26016305569",3396,2,62,3,0,32,3495
"380","G26016305570",3117,27,46,6,0,54,3250
"381","G26016305571",2448,16,10,8,2,38,2522
"382","G26016305572",1954,1,19,4,0,13,1991
"383","G26016305573",2100,0,27,3,0,29,2159
"384","G26016305574",3725,1,53,5,0,32,3816
"385","G26016305575",4417,9,45,7,0,58,4536
"386","G26016305576",3700,13,118,5,1,48,3885
"387","G26016305577",5171,0,75,1,0,61,5308
"388","G26016305579",5615,25,68,7,0,75,5790
"389","G26016305580",4703,3,45,8,2,74,4835
"390","G26016305581",3680,5,41,6,0,66,3798
"391","G26016305582",4242,8,47,10,0,60,4367
"392","G26016305583",1573,15,8,9,0,36,1641
"393","G26016305584",3433,12,64,1,0,39,3549
"394","G26016305585",4232,8,31,6,0,38,4315
"395","G26016305586",1712,3,29,6,1,8,1759
"396","G26016305587",2943,9,27,7,0,33,3019
"397","G26016305588",3160,0,25,4,0,66,3255
"398","G26016305589",2029,1,37,4,0,18,2089
"399","G26016305590",2972,0,16,9,0,56,3053
"400","G26016305591",2766,4,37,10,1,53,2871
"401","G26016305592",2038,0,10,4,0,41,2093
"402","G26016305601",2827,4,23,9,0,20,2883
"403","G26016305602",4510,27,166,6,12,53,4774
"404","G26016305603",3008,21,118,7,1,48,3203
"405","G26016305604",4564,4,105,17,1,31,4722
"406","G26016305605",313,403,3,4,0,9,732
"407","G26016305607",2708,7,21,7,0,15,2758
"408","G26016305608",468,591,8,5,0,28,1100
"409","G26016305616",3878,9,52,7,0,56,4002
"410","G26016305617",1261,0,3,9,0,20,1293
"411","G26016305618",127,205,15,6,0,22,375
"412","G26016305619",2467,13,55,1,1,29,2566
"413","G26016305620",7512,35,179,11,0,81,7818
"414","G26016305621",5797,8,72,20,1,49,5947
"415","G26016305622",1647,4,7,3,0,14,1675
"416","G26016305625",2087,8,11,8,0,35,2149
"417","G26016305626",3580,18,12,7,1,40,3658
"418","G26016305627",3651,3,20,20,1,30,3725
"419","G26016305632",3333,159,101,9,8,62,3672
"420","G26016305633",2674,46,83,10,0,44,2857
"421","G26016305634",5324,74,319,7,4,69,5797
"422","G26016305635",4423,132,408,0,1,55,5019
"423","G26016305636",1866,15,115,2,0,32,2030
"424","G26016305637",1781,50,96,10,0,28,1965
"425","G26016305638",3146,63,173,14,1,34,3431
"426","G26016305639",1701,31,139,2,0,29,1902
"427","G26016305640",1522,61,17,7,0,24,1631
"428","G26016305641",3001,41,321,5,3,56,3427
"429","G26016305642",3675,65,202,11,0,76,4029
"430","G26016305643",1939,56,134,0,1,39,2169
"431","G26016305644",1347,0,12,11,3,6,1379
"432","G26016305645",2967,27,27,20,4,17,3062
"433","G26016305646",3135,58,126,4,1,54,3378
"434","G26016305647",2860,77,43,8,1,46,3035
"435","G26016305648",2795,91,77,11,0,62,3036
"436","G26016305649",2161,36,14,15,0,15,2241
"437","G26016305650",2731,73,125,6,8,44,2987
"438","G26016305664",1068,139,5,10,0,36,1258
"439","G26016305665",2301,84,73,19,0,58,2535
"440","G26016305666",1586,138,12,7,0,39,1782
"441","G26016305667",4377,36,11,37,3,129,4593
"442","G26016305668",3102,121,18,33,0,51,3325
"443","G26016305669",5248,969,40,22,7,120,6406
"444","G26016305671",4068,14,28,14,0,69,4193
"445","G26016305672",7012,54,71,24,0,144,7305
"446","G26016305673",4888,27,69,20,0,86,5090
"447","G26016305674",2948,14,26,3,2,49,3042
"448","G26016305675",3692,236,54,15,2,90,4089
"449","G26016305676",5326,180,91,33,0,93,5723
"450","G26016305677",4935,143,107,25,0,102,5312
"451","G26016305678",5210,68,89,20,2,134,5523
"452","G26016305679",3133,8,26,20,2,49,3238
"453","G26016305680",1716,38,18,14,0,32,1818
"454","G26016305681",5206,42,38,28,0,71,5385
"455","G26016305682",4129,28,30,18,6,47,4258
"456","G26016305683",4858,42,18,30,0,84,5032
"457","G26016305684",4028,25,25,27,1,98,4204
"458","G26016305685",5396,19,16,76,2,146,5655
"459","G26016305686",6972,82,59,47,0,148,7308
"460","G26016305687",3466,202,51,9,0,87,3815
"461","G26016305688",208,109,0,1,0,7,325
"462","G26016305689",1342,899,7,22,3,38,2311
"463","G26016305690",495,572,3,8,0,20,1098
"464","G26016305691",2831,1,2,14,0,54,2902
"465","G26016305692",3235,12,12,18,0,53,3330
"466","G26016305693",4187,4,19,26,1,62,4299
"467","G26016305694",3240,9,20,8,0,44,3321
"468","G26016305695",3178,7,11,14,2,41,3253
"469","G26016305696",4106,5,28,8,1,59,4207
"470","G26016305697",4716,5,37,18,2,72,4850
"471","G26016305698",2718,17,20,15,0,52,2822
"472","G26016305699",2787,14,5,10,0,46,2862
"473","G26016305701",2642,980,114,21,1,85,3843
"474","G26016305702",2681,487,12,20,10,86,3296
"475","G26016305703",1213,567,3,15,1,21,1820
"476","G26016305704",1707,2274,18,18,3,37,4057
"477","G26016305705",1978,2448,20,18,9,34,4507
"478","G26016305706",41,2724,4,10,2,5,2786
"479","G26016305707",20,1562,4,4,0,4,1594
"480","G26016305708",53,2547,7,4,7,16,2634
"481","G26016305709",113,3129,16,3,7,12,3280
"482","G26016305710",477,2426,3,9,8,32,2955
"483","G26016305715",3628,71,71,12,8,99,3889
"484","G26016305716",1600,14,29,5,0,45,1693
"485","G26016305717",2163,17,23,11,1,54,2269
"486","G26016305718",3060,2,8,4,2,73,3149
"487","G26016305719",2953,4,34,4,0,54,3049
"488","G26016305720",1860,0,13,4,0,27,1904
"489","G26016305721",6255,2,63,13,0,140,6473
"490","G26016305722",6341,5,66,7,0,141,6560
"491","G26016305723",6767,69,222,9,0,70,7137
"492","G26016305724",1368,5,15,7,0,46,1441
"493","G26016305725",1980,38,7,7,0,60,2092
"494","G26016305726",5669,14,65,44,9,188,5989
"495","G26016305727",5189,14,54,39,0,124,5420
"496","G26016305728",6407,13,44,58,2,175,6699
"497","G26016305729",2928,6,42,7,0,103,3086
"498","G26016305735",4244,45,84,26,10,136,4545
"499","G26016305736",5710,15,56,17,8,218,6024
"500","G26016305737",6391,17,65,18,9,233,6733
"501","G26016305738",4138,11,54,25,1,144,4373
"502","G26016305739",6620,7,46,26,2,301,7002
"503","G26016305740",7050,8,79,23,4,317,7481
"504","G26016305741",2680,9,12,19,1,128,2849
"505","G26016305742",1919,35,30,4,0,27,2015
"506","G2601630574299",75,8,0,0,0,3,86
"507","G26016305743",2174,77,30,9,1,97,2388
"508","G26016305744",574,21,40,2,9,44,690
"509","G26016305745",3023,105,32,7,0,68,3235
"510","G26016305746",4904,69,13,3,0,94,5083
"511","G26016305747",4467,3,26,10,1,88,4595
"512","G26016305748",4161,0,36,9,1,51,4258
"513","G26016305749",1629,7,23,4,0,34,1697
"514","G26016305750",4641,4,27,12,0,91,4775
"515","G26016305751",2887,4,29,6,0,47,2973
"516","G26016305752",4408,33,42,10,0,92,4585
"517","G26016305753",3887,6,10,22,2,85,4012
"518","G26016305754",3550,1,42,4,1,74,3672
"519","G26016305755",4306,3,35,11,1,83,4439
"520","G26016305756",1733,2,10,3,0,28,1776
"521","G26016305760",1981,131,43,5,0,110,2270
"522","G26016305761",6344,1,65,20,1,278,6709
"523","G26016305762",2734,0,6,5,1,87,2833
"524","G26016305763",2442,0,15,2,1,75,2535
"525","G26016305764",3942,2,17,10,3,105,4079
"526","G26016305765",4057,1,27,2,0,85,4172
"527","G26016305766",4656,0,24,12,0,139,4831
"528","G26016305767",3488,9,24,5,0,106,3632
"529","G26016305770",3759,307,24,26,4,195,4315
"530","G26016305771",3067,13,13,22,4,159,3278
"531","G26016305772",3415,21,25,18,1,149,3629
"532","G26016305773",3590,6,10,27,0,152,3785
"533","G26016305774",3725,6,11,4,1,162,3909
"534","G26016305775",3450,4,12,24,1,119,3610
"535","G26016305776",4266,0,13,24,0,128,4431
"536","G26016305777",2430,2,17,6,6,59,2520
"537","G26016305778",5070,9,10,14,0,247,5350
"538","G26016305779",4261,8,22,15,1,145,4452
"539","G26016305780",2439,5,12,24,0,73,2553
"540","G26016305785",4797,21,60,40,3,309,5230
"541","G26016305786",5299,298,32,55,3,318,6005
"542","G26016305791",2832,238,10,27,0,118,3225
"543","G26016305792",4030,303,18,29,3,237,4620
"544","G26016305793",23,3417,3,13,2,23,3481
"545","G26016305795",1983,127,2,35,1,95,2243
"546","G2601630579599",17,3,0,0,0,0,20
"547","G26016305796",29,4162,6,7,2,21,4227
"548","G26016305797",2562,353,24,29,7,533,3508
"549","G26016305798",1857,114,3,22,3,171,2170
"550","G26016305801",2788,2,19,42,1,91,2943
"551","G26016305802",3381,3,15,19,0,86,3504
"552","G26016305803",3207,2,3,27,0,92,3331
"553","G26016305804",2821,5,20,15,0,43,2904
"554","G26016305805",3145,3,9,4,0,42,3203
"555","G26016305806",3611,2,5,10,0,45,3673
"556","G26016305807",4291,15,18,14,1,107,4446
"557","G2601630580799",13,0,0,0,0,1,14
"558","G26016305808",2011,12,8,25,0,61,2117
"559","G26016305809",4643,29,22,24,0,85,4803
"560","G26016305815",2501,0,11,9,0,32,2553
"561","G26016305816",4418,5,60,19,0,112,4614
"562","G26016305817",6361,204,165,39,2,266,7037
"563","G26016305818",3145,2,22,15,2,85,3271
"564","G26016305819",5130,6,13,11,2,158,5320
"565","G26016305820",2928,140,38,18,0,89,3213
"566","G26016305821",4598,0,20,28,3,114,4763
"567","G26016305830",3070,3,8,18,1,70,3170
"568","G26016305831",4763,16,9,38,0,108,4934
"569","G26016305832",3214,3,4,22,1,76,3320
"570","G26016305833",2958,5,18,17,0,71,3069
"571","G26016305834",5765,5,16,34,0,135,5955
"572","G26016305835",3109,12,18,12,2,97,3250
"573","G26016305836",2973,3,25,10,0,92,3103
"574","G26016305837",3778,23,28,6,2,135,3972
"575","G26016305838",4745,52,70,29,3,145,5044
"576","G26016305839",3795,224,86,20,6,115,4246
"577","G26016305840",4420,352,51,17,1,167,5008
"578","G26016305841",2247,8,9,17,1,54,2336
"579","G26016305842",3484,263,73,24,1,107,3952
"580","G26016305843",1564,86,72,15,2,52,1791
"581","G26016305844",2987,45,24,15,8,103,3182
"582","G26016305845",2063,84,18,6,0,49,2220
"583","G26016305846",1866,223,88,18,6,89,2290
"584","G26016305847",2882,33,69,19,0,77,3080
"585","G26016305848",4889,1516,181,50,4,249,6889
"586","G26016305855",2897,41,9,28,0,73,3048
"587","G26016305856",482,1570,13,5,5,28,2103
"588","G26016305857",1740,537,4,17,3,33,2334
"589","G26016305858",1208,1011,13,8,9,48,2297
"590","G26016305859",2417,791,12,18,12,45,3295
"591","G26016305860",171,35,0,6,0,4,216
"592","G26016305861",422,9,0,0,0,5,436
"593","G26016305862",5647,966,86,38,5,165,6907
"594","G26016305863",2183,8,14,23,0,33,2261
"595","G26016305870",4497,72,10,14,1,61,4655
"596","G26016305879",3195,508,15,22,2,57,3799
"597","G26016305880",3536,185,35,16,0,65,3837
"598","G26016305881",2391,30,11,12,1,22,2467
"599","G26016305882",2419,578,81,17,4,71,3170
"600","G26016305883",2821,90,14,25,3,42,2995
"601","G26016305884",3058,191,44,7,4,46,3350
"602","G26016305890",5546,460,15,22,9,74,6126
"603","G26016305891",2995,35,6,16,4,57,3113
"604","G26016305892",647,983,3,7,1,11,1652
"605","G26016305903",7117,23,6,48,2,149,7345
"606","G26016305904",3022,13,10,7,0,50,3102
"607","G26016305915",4996,239,301,20,2,161,5719
"608","G26016305916",688,56,0,10,0,18,772
"609","G26016305917",2869,35,48,20,3,97,3072
"610","G26016305918",2192,125,8,23,3,60,2411
"611","G26016305919",4700,23,100,11,1,128,4963
"612","G26016305920",1838,9,2,7,2,26,1884
"613","G26016305930",4390,31,90,23,1,97,4632
"614","G26016305931",6557,43,167,22,2,206,6997
"615","G26016305940",2592,3,25,19,0,51,2690
"616","G26016305941",4771,8,75,16,4,60,4934
"617","G26016305942",2876,0,34,8,0,59,2977
"618","G26016305943",3503,6,27,4,0,36,3576
"619","G26016305944",2425,1,8,15,0,28,2477
"620","G26016305945",3799,14,61,5,0,49,3928
"621","G26016305950",4498,14,18,17,1,59,4607
"622","G26016305951",5619,98,212,11,2,110,6052
"623","G26016305952",3058,49,71,6,1,50,3235
"624","G26016305960",5759,7,274,17,1,82,6140
"625","G26016305961",3505,0,73,11,0,52,3641
"626","G26016305970",4209,7,18,18,0,41,4293
"627","G26016305980",3053,2,33,19,1,41,3149
"628","G26016305990",2538,25,10,7,0,64,2644
"629","G26016305991",4481,26,32,23,1,75,4638
