,GISJOIN_T,X,whites,blacks,asians,native_americans,others,latino,tot
1,G2601630500100,1,366,3553,5,6,64,38,4032
2,G2601630500200,2,233,2907,14,10,30,13,3207
3,G2601630500300,3,191,2761,82,7,60,36,3137
4,G2601630500400,4,60,1542,1,9,29,23,1664
5,G2601630500500,5,50,2103,5,11,23,13,2205
6,G2601630500600,6,135,3440,23,4,92,20,3714
7,G2601630500700,7,331,3892,6,2,117,43,4391
8,G2601630500800,8,261,2164,13,4,22,21,2485
9,G2601630500900,9,125,3779,16,10,62,43,4035
10,G2601630501000,10,80,3313,4,7,65,30,3499
11,G2601630501100,11,102,3596,1,2,44,17,3762
12,G2601630501200,12,51,1887,0,1,20,4,1963
13,G2601630501300,13,87,3649,1,15,70,14,3836
14,G2601630501400,14,286,3471,8,4,79,47,3895
15,G2601630501500,15,522,3437,31,15,56,34,4095
16,G2601630501600,16,414,1474,2,3,56,48,1997
17,G2601630501700,17,586,1646,4,9,79,33,2357
18,G2601630501800,18,751,3451,27,7,153,59,4448
19,G2601630501900,19,120,2841,7,10,55,22,3055
20,G2601630502000,20,81,2197,0,13,39,18,2348
21,G2601630503100,21,163,2836,28,4,30,20,3081
22,G2601630503200,22,201,3462,26,8,83,37,3817
23,G2601630503300,23,144,4015,55,6,66,16,4302
24,G2601630503400,24,72,1270,163,2,29,21,1557
25,G2601630503500,25,107,3613,116,2,70,28,3936
26,G2601630503600,26,93,1631,163,4,37,11,1939
27,G2601630503900,27,36,2172,2,2,32,6,2250
28,G2601630504000,28,35,1412,1,10,18,7,1483
29,G2601630504100,29,36,1655,1,4,39,13,1748
30,G2601630504200,30,17,2356,0,5,36,12,2426
31,G2601630504300,31,66,2548,9,1,54,17,2695
32,G2601630504400,32,28,1945,2,2,17,5,1999
33,G2601630504700,33,26,2033,2,3,24,9,2097
34,G2601630504800,34,42,736,0,0,8,7,793
35,G2601630504900,35,109,3313,4,2,46,21,3495
36,G2601630505000,36,40,1198,1,0,19,5,1263
37,G2601630505100,37,226,3457,4,13,44,32,3776
38,G2601630505200,38,80,3192,1,10,49,16,3348
39,G2601630505400,39,91,2765,65,2,49,29,3001
40,G2601630505500,40,85,1340,1,16,17,13,1472
41,G2601630506100,41,113,1723,23,15,37,10,1921
42,G2601630506200,42,85,2137,3,8,27,25,2285
43,G2601630506300,43,88,2182,8,8,48,18,2352
44,G2601630506400,44,626,2287,9,11,30,132,3095
45,G2601630506500,45,50,2115,4,3,48,36,2256
46,G2601630506600,46,104,3044,2,4,56,30,3240
47,G2601630506700,47,37,1151,7,1,19,14,1229
48,G2601630506800,48,149,3600,2,6,66,42,3865
49,G2601630506900,49,117,3584,4,9,69,35,3818
50,G2601630507000,50,29,2819,3,12,53,32,2948
51,G2601630507100,51,26,2528,3,6,30,24,2617
52,G2601630507200,52,16,1381,1,0,23,13,1434
53,G2601630507300,53,30,2706,5,10,42,21,2814
54,G2601630507400,54,51,3035,4,7,38,18,3153
55,G2601630507500,55,97,2325,5,3,24,25,2479
56,G2601630507800,56,63,689,0,0,15,5,772
57,G2601630507900,57,263,1764,22,24,58,69,2200
58,G2601630508000,58,260,1028,2,1,37,15,1343
59,G2601630508100,59,181,1957,16,3,43,27,2227
60,G2601630510400,60,12,939,0,0,18,7,976
61,G2601630510500,61,398,1182,1987,22,101,33,3723
62,G2601630510600,62,1268,1073,1581,21,201,62,4206
63,G2601630510700,63,1137,527,68,1,145,10,1888
64,G2601630511000,64,86,1780,30,6,34,35,1971
65,G2601630511200,65,14,1360,7,0,52,9,1442
66,G2601630511300,66,534,1826,37,7,88,18,2510
67,G2601630511400,67,54,2522,8,9,54,34,2681
68,G2601630511900,68,60,1326,9,6,51,10,1462
69,G2601630512100,69,60,3365,7,17,60,23,3532
70,G2601630512200,70,15,1282,1,5,12,6,1321
71,G2601630512300,71,28,1564,13,11,47,14,1677
72,G2601630512400,72,22,1427,0,6,9,17,1481
73,G2601630512600,73,60,1856,0,3,20,14,1953
74,G2601630512900,74,91,1467,3,8,45,25,1639
75,G2601630513200,75,220,1559,3,3,38,20,1843
76,G2601630513300,76,236,1972,11,6,57,18,2300
77,G2601630513600,77,64,1377,0,0,21,7,1469
78,G2601630513700,78,51,3109,16,17,53,10,3256
79,G2601630513900,79,26,2154,1,2,39,13,2235
80,G2601630514100,80,52,3339,4,14,55,22,3486
81,G2601630514200,81,15,2651,1,3,40,16,2726
82,G2601630514300,82,63,2956,1,4,27,24,3075
83,G2601630514500,83,18,1367,7,2,13,9,1416
84,G2601630515200,84,116,1865,4,9,25,13,2032
85,G2601630515300,85,198,2814,14,11,48,32,3117
86,G2601630515400,86,426,826,8,10,50,24,1344
87,G2601630515600,87,31,1305,0,6,33,10,1385
88,G2601630515700,88,380,2765,24,7,88,31,3295
89,G2601630515900,89,34,1587,0,1,15,6,1643
90,G2601630516000,90,66,2906,1,15,48,16,3052
91,G2601630516100,91,11,706,2,6,7,2,734
92,G2601630516200,92,20,739,0,0,10,5,774
93,G2601630516300,93,51,821,2,1,9,6,890
94,G2601630516400,94,83,969,7,3,21,12,1095
95,G2601630516500,95,243,1061,15,3,52,30,1404
96,G2601630516600,96,13,1963,1,8,57,16,2058
97,G2601630516700,97,30,2849,9,12,62,15,2977
98,G2601630516800,98,31,961,0,9,25,15,1041
99,G2601630516900,99,92,1836,2,4,42,15,1991
100,G2601630517000,100,568,1620,86,6,42,38,2360
101,G2601630517100,101,106,909,8,5,16,18,1062
102,G2601630517200,102,381,908,49,10,37,53,1438
103,G2601630517300,103,289,1557,21,6,47,23,1943
104,G2601630517500,104,225,1778,96,5,63,25,2192
105,G2601630518000,105,534,1551,62,1,55,61,2264
106,G2601630518400,106,105,472,5,2,29,17,630
107,G2601630518500,107,161,990,0,5,28,26,1210
108,G2601630518600,108,17,758,0,1,18,3,797
109,G2601630518800,109,45,721,3,1,15,10,795
110,G2601630518900,110,41,1757,5,3,37,11,1854
111,G2601630520200,111,1061,819,493,11,129,58,2571
112,G2601630520300,112,713,858,341,16,63,47,2038
113,G2601630520400,113,385,1247,88,6,68,41,1835
114,G2601630520700,114,480,1572,39,6,67,69,2233
115,G2601630520800,115,538,857,124,5,47,45,1616
116,G2601630521100,116,335,602,2,18,56,1067,2080
117,G2601630521300,117,70,744,1,1,10,128,954
118,G2601630521400,118,448,487,14,10,27,206,1192
119,G2601630521500,119,288,1243,2,3,51,103,1690
120,G2601630521800,120,26,1150,1,7,21,11,1216
121,G2601630521900,121,787,1930,26,27,74,98,2942
122,G2601630522000,122,65,1907,2,6,34,47,2061
123,G2601630522100,123,24,842,8,5,5,66,950
124,G2601630522200,124,13,608,0,1,6,27,655
125,G2601630522300,125,21,1624,0,6,30,23,1704
126,G2601630522400,126,55,1027,5,4,28,28,1147
127,G2601630522500,127,281,1307,14,16,34,55,1707
128,G2601630523100,128,287,280,3,11,35,1032,1648
129,G2601630523200,129,636,190,12,6,69,2937,3850
130,G2601630523300,130,427,294,4,8,39,2554,3326
131,G2601630523400,131,516,732,3,12,46,1411,2720
132,G2601630523800,132,988,264,21,16,77,3216,4582
133,G2601630524000,133,515,140,23,15,34,2258,2985
134,G2601630524100,134,832,264,1,19,66,2760,3942
135,G2601630524200,135,1058,262,12,12,48,3572,4964
136,G2601630524300,136,653,95,6,23,41,1994,2812
137,G2601630524500,137,366,90,6,3,40,759,1264
138,G2601630524700,138,51,3894,1,11,55,138,4150
139,G2601630524800,139,50,2585,1,9,29,122,2796
140,G2601630524900,140,436,309,7,5,34,888,1679
141,G2601630525000,141,285,375,1,3,24,416,1104
142,G2601630525400,142,220,1308,29,2,20,795,2374
143,G2601630525500,143,41,688,9,0,16,437,1191
144,G2601630525600,144,333,133,6,8,19,1172,1671
145,G2601630525700,145,998,244,38,12,88,3624,5004
146,G2601630525800,146,382,277,7,6,41,1378,2091
147,G2601630526000,147,1271,241,15,7,143,1307,2984
148,G2601630526100,148,1473,158,4,6,127,863,2631
149,G2601630526200,149,1054,310,11,5,110,1686,3176
150,G2601630526300,150,525,470,19,12,75,2534,3635
151,G2601630526400,151,147,472,13,3,22,943,1600
152,G2601630526500,152,37,2158,2,7,72,206,2482
153,G2601630527200,153,4,1116,0,1,24,45,1190
154,G2601630527300,154,10,1128,0,10,27,100,1275
155,G2601630530100,155,18,2928,2,4,43,29,3024
156,G2601630530200,156,517,3367,135,18,72,83,4192
157,G2601630530300,157,16,1817,4,8,37,9,1891
158,G2601630530400,158,5,1654,0,6,16,13,1694
159,G2601630530500,159,43,2170,3,1,56,10,2283
160,G2601630530800,160,28,2044,0,5,35,18,2130
161,G2601630530900,161,20,2591,2,9,40,32,2694
162,G2601630531100,162,82,1466,4,7,28,23,1610
163,G2601630531200,163,88,2326,0,8,61,49,2532
164,G2601630531300,164,29,1412,0,3,44,9,1497
165,G2601630531400,165,11,1865,2,11,21,25,1935
166,G2601630531500,166,40,2906,1,4,46,21,3018
167,G2601630531600,167,23,1920,3,3,24,8,1981
168,G2601630531700,168,22,1982,2,6,51,7,2070
169,G2601630531800,169,22,2078,2,0,28,9,2139
170,G2601630531900,170,56,1348,0,1,11,9,1425
171,G2601630532200,171,39,1604,3,2,32,16,1696
172,G2601630532300,172,112,802,5,5,30,8,962
173,G2601630532400,173,67,1509,4,11,30,14,1635
174,G2601630532600,174,106,1742,79,6,43,67,2043
175,G2601630532700,175,16,915,0,2,15,14,962
176,G2601630533000,176,77,1683,3,2,17,22,1804
177,G2601630533100,177,7,1769,0,2,30,16,1824
178,G2601630533200,178,12,1604,0,2,24,14,1656
179,G2601630533300,179,35,1700,5,9,34,12,1795
180,G2601630533400,180,24,2959,2,4,51,29,3069
181,G2601630533500,181,6,1268,0,3,21,24,1322
182,G2601630533600,182,9,2370,1,2,51,13,2446
183,G2601630533700,183,16,1184,0,4,26,12,1242
184,G2601630533900,184,250,2199,32,2,58,37,2578
185,G2601630534100,185,14,1986,0,15,26,29,2070
186,G2601630534200,186,24,4060,0,13,56,26,4179
187,G2601630534300,187,22,1454,2,3,32,8,1521
188,G2601630534400,188,19,1889,1,8,25,16,1958
189,G2601630534500,189,9,950,1,0,11,9,980
190,G2601630534600,190,24,1762,2,8,43,63,1902
191,G2601630534700,191,33,2945,3,8,25,28,3042
192,G2601630535000,192,49,2533,2,6,27,44,2661
193,G2601630535100,193,31,1992,0,4,19,21,2067
194,G2601630535200,194,32,2381,1,7,45,21,2487
195,G2601630535300,195,59,3889,1,7,48,24,4028
196,G2601630535400,196,18,1460,2,7,29,6,1522
197,G2601630535500,197,92,2513,2,4,47,18,2676
198,G2601630535600,198,108,3215,7,3,57,35,3425
199,G2601630535700,199,10,1438,3,3,19,13,1486
200,G2601630536100,200,83,3663,4,4,71,21,3846
201,G2601630536200,201,25,1920,4,2,49,12,2012
202,G2601630536300,202,15,3019,0,8,63,25,3130
203,G2601630536400,203,14,2781,3,4,47,19,2868
204,G2601630536500,204,12,2273,6,5,48,19,2363
205,G2601630536600,205,30,2849,0,5,44,18,2946
206,G2601630536700,206,18,1335,1,1,27,9,1391
207,G2601630536800,207,10,1590,0,10,28,8,1646
208,G2601630536900,208,23,3370,2,11,62,29,3497
209,G2601630537000,209,57,3494,0,16,43,31,3641
210,G2601630537100,210,20,2064,1,4,48,41,2178
211,G2601630537200,211,12,857,0,2,12,5,888
212,G2601630537300,212,37,2601,5,6,54,47,2750
213,G2601630537500,213,25,2883,1,13,36,8,2966
214,G2601630537600,214,48,3119,4,3,42,27,3243
215,G2601630537700,215,26,3072,6,5,56,13,3178
216,G2601630537800,216,36,1953,4,9,25,8,2035
217,G2601630538100,217,232,1755,10,5,49,25,2076
218,G2601630538200,218,229,1593,10,1,52,26,1911
219,G2601630538300,219,80,1993,4,10,28,19,2134
220,G2601630538400,220,270,2931,22,4,73,42,3342
221,G2601630538500,221,29,4983,8,11,84,43,5158
222,G2601630538600,222,19,4526,8,11,71,34,4669
223,G2601630538700,223,18,3502,5,7,42,32,3606
224,G2601630538800,224,6,1374,1,3,19,1,1404
225,G2601630538900,225,44,3361,1,6,73,41,3526
226,G2601630539000,226,20,2792,5,5,52,15,2889
227,G2601630539100,227,13,1742,2,3,31,3,1794
228,G2601630539200,228,47,4544,7,14,62,36,4710
229,G2601630539300,229,27,3562,5,8,53,39,3694
230,G2601630539400,230,19,3389,2,4,49,16,3479
231,G2601630539500,231,26,2855,7,6,44,25,2963
232,G2601630539600,232,35,3196,4,3,55,17,3310
233,G2601630539700,233,20,1817,4,1,35,14,1891
234,G2601630540100,234,47,3153,1,6,63,30,3300
235,G2601630540200,235,40,3611,5,10,81,24,3771
236,G2601630540300,236,33,3724,1,4,39,22,3823
237,G2601630540400,237,44,2453,12,4,41,15,2569
238,G2601630540500,238,70,3154,4,4,39,25,3296
239,G2601630540600,239,44,3165,2,6,65,19,3301
240,G2601630540700,240,54,3210,5,3,57,17,3346
241,G2601630540800,241,38,2081,2,7,27,19,2174
242,G2601630540900,242,73,3320,3,5,55,10,3466
243,G2601630541000,243,69,3467,1,8,56,33,3634
244,G2601630541100,244,108,3432,3,9,69,15,3636
245,G2601630541200,245,132,2200,10,13,43,26,2424
246,G2601630541300,246,589,1701,18,5,63,53,2429
247,G2601630541400,247,353,2177,10,3,58,33,2634
248,G2601630541500,248,92,3289,5,5,49,36,3476
249,G2601630541700,249,51,2028,3,10,34,6,2132
250,G2601630541800,250,499,1846,43,4,68,35,2495
251,G2601630542100,251,57,4181,2,23,57,30,4350
252,G2601630542200,252,55,3639,2,13,53,19,3781
253,G2601630542300,253,43,2135,4,2,25,16,2225
254,G2601630542400,254,31,2498,2,3,52,36,2622
255,G2601630542500,255,81,2326,1,10,40,31,2489
256,G2601630542600,256,13,3067,1,1,40,8,3130
257,G2601630542700,257,16,903,0,7,6,5,937
258,G2601630542800,258,60,2405,2,2,54,8,2531
259,G2601630542900,259,208,3055,12,4,76,22,3377
260,G2601630543000,260,171,1609,1,1,27,5,1814
261,G2601630543100,261,177,2144,19,4,48,14,2406
262,G2601630543200,262,95,2615,4,5,50,35,2804
263,G2601630543400,263,74,3021,5,10,36,43,3189
264,G2601630543500,264,107,1406,4,4,44,34,1599
265,G2601630543600,265,257,1292,0,10,67,50,1676
266,G2601630543700,266,155,2379,2,10,76,27,2649
267,G2601630543800,267,185,828,7,9,35,29,1093
268,G2601630543900,268,141,720,0,2,14,24,901
269,G2601630544000,269,193,1890,6,7,60,22,2178
270,G2601630544100,270,121,1628,5,0,35,14,1803
271,G2601630544200,271,288,2090,15,12,48,14,2467
272,G2601630544300,272,743,1648,21,13,65,59,2549
273,G2601630545100,273,56,1444,0,3,24,17,1544
274,G2601630545200,274,68,3115,13,8,52,24,3280
275,G2601630545300,275,31,2091,0,7,22,11,2162
276,G2601630545400,276,45,695,1,0,7,10,758
277,G2601630545500,277,923,2499,5,5,97,143,3672
278,G2601630545600,278,2449,1467,38,9,201,389,4553
279,G2601630545700,279,1013,962,6,3,48,341,2373
280,G2601630545800,280,1505,2462,19,12,166,544,4708
281,G2601630545900,281,744,2999,5,11,76,203,4038
282,G2601630546000,282,254,3266,3,8,59,84,3674
283,G2601630546100,283,437,3524,8,10,94,112,4185
284,G2601630546200,284,836,1792,32,7,69,127,2863
285,G2601630546300,285,184,1412,10,5,26,18,1655
286,G2601630546400,286,57,1173,1,7,20,23,1281
287,G2601630546500,287,81,2239,4,1,21,11,2357
288,G2601630546600,288,102,2016,2,8,44,22,2194
289,G2601630546700,289,115,2926,0,18,56,37,3152
290,G2601630546800,290,86,2976,6,3,68,32,3171
291,G2601630546900,291,22,1122,3,8,24,19,1198
292,G2601630550100,292,3297,413,76,5,85,74,3950
293,G2601630550200,293,3100,693,101,12,119,138,4163
294,G2601630550300,294,3199,104,31,1,28,79,3442
295,G2601630550400,295,1421,82,35,6,41,42,1627
296,G2601630550500,296,3552,94,53,0,39,56,3794
297,G2601630550600,297,2377,25,26,1,10,47,2486
298,G2601630550700,298,5115,92,64,6,59,118,5454
299,G2601630550800,299,1413,47,28,9,19,23,1539
300,G2601630550900,300,2675,57,109,5,29,54,2929
301,G2601630551100,301,4521,123,84,5,48,75,4856
302,G2601630551200,302,3524,306,58,0,98,85,4071
303,G2601630551300,303,2317,1300,91,12,66,63,3849
304,G2601630551400,304,1790,2102,62,5,96,95,4150
305,G2601630551500,305,1191,1093,22,12,67,40,2425
306,G2601630551600,306,1611,1956,31,2,129,83,3812
307,G2601630551700,307,3204,74,141,1,21,47,3488
308,G2601630551800,308,3276,222,106,8,45,63,3720
309,G2601630552000,309,1470,250,945,7,112,33,2817
310,G2601630552100,310,1799,1402,948,11,147,51,4358
311,G2601630552200,311,2199,502,704,10,117,38,3570
312,G2601630552300,312,1849,432,1025,17,157,47,3527
313,G2601630552400,313,1336,640,719,3,126,76,2900
314,G2601630552800,314,3223,1059,467,10,409,83,5251
315,G2601630553000,315,45,1142,7,5,29,16,1244
316,G2601630553100,316,78,1561,12,3,35,7,1696
317,G2601630553200,317,8,850,3,1,21,22,905
318,G2601630553300,318,21,1269,0,4,40,29,1363
319,G2601630553400,319,31,1895,2,5,38,12,1983
320,G2601630553600,320,122,2399,23,6,35,46,2631
321,G2601630553800,321,42,1839,2,2,45,24,1954
322,G2601630554100,322,2780,997,41,36,133,134,4121
323,G2601630554200,323,2473,562,44,14,105,103,3301
324,G2601630554300,324,4059,707,33,13,82,134,5028
325,G2601630554400,325,2157,882,34,26,60,88,3247
326,G2601630554500,326,1906,710,28,19,76,65,2804
327,G2601630554600,327,3164,457,17,19,90,113,3860
328,G2601630554700,328,2017,380,14,5,24,74,2514
329,G2601630554800,329,1664,1730,27,4,68,97,3590
330,G2601630554900,330,1843,1285,32,11,86,78,3335
331,G2601630555100,331,3458,758,47,17,115,168,4563
332,G2601630555300,332,1789,1379,22,14,73,107,3384
333,G2601630555400,333,557,2081,34,7,88,94,2861
334,G2601630555500,334,1510,1344,18,10,75,100,3057
335,G2601630555600,335,1915,619,13,11,74,65,2697
336,G2601630556100,336,2975,241,81,22,76,113,3508
337,G2601630556200,337,2266,217,129,6,33,63,2714
338,G2601630556300,338,2808,207,161,3,36,101,3316
339,G2601630556400,339,3791,157,221,3,75,93,4340
340,G2601630556500,340,2089,67,65,1,24,36,2282
341,G2601630556600,341,3234,20,82,7,35,60,3438
342,G2601630556700,342,2466,31,78,3,20,53,2651
343,G2601630556800,343,1671,17,31,0,22,48,1789
344,G2601630556900,344,3273,127,219,6,47,107,3779
345,G2601630557000,345,2477,297,112,15,31,107,3039
346,G2601630557100,346,2101,262,98,5,46,56,2568
347,G2601630557200,347,1867,35,35,6,30,41,2014
348,G2601630557300,348,1999,66,40,5,11,44,2165
349,G2601630557400,349,3223,9,50,10,23,100,3415
350,G2601630557500,350,3675,39,73,8,44,73,3912
351,G2601630557600,351,2975,49,54,5,32,68,3183
352,G2601630557700,352,4257,41,34,11,48,62,4453
353,G2601630557900,353,4711,81,86,13,44,108,5043
354,G2601630558000,354,4014,63,39,11,57,111,4295
355,G2601630558100,355,3052,124,89,4,50,113,3432
356,G2601630558200,356,3857,339,212,6,92,118,4624
357,G2601630558300,357,1817,91,16,10,47,63,2044
358,G2601630558400,358,3417,175,106,2,54,82,3836
359,G2601630558500,359,3724,110,37,18,45,96,4030
360,G2601630558600,360,1898,36,68,4,35,57,2098
361,G2601630558700,361,2616,20,27,2,22,59,2746
362,G2601630558800,362,2639,32,25,2,47,61,2806
363,G2601630558900,363,1723,58,30,4,21,61,1897
364,G2601630559000,364,2467,73,43,4,51,77,2715
365,G2601630559100,365,2323,118,51,7,48,88,2635
366,G2601630559200,366,1927,62,60,1,45,80,2175
367,G2601630560100,367,2516,54,62,2,56,49,2739
368,G2601630560200,368,4364,312,435,10,121,166,5408
369,G2601630560300,369,2806,195,293,3,64,46,3407
370,G2601630560400,370,5549,122,289,3,71,119,6153
371,G2601630561200,371,3779,204,1363,9,124,162,5641
372,G2601630561300,372,6551,188,834,7,130,178,7888
373,G2601630561600,373,3566,43,69,11,32,111,3832
374,G2601630561700,374,1860,50,79,6,54,88,2137
375,G2601630561900,375,6146,197,490,8,108,162,7111
376,G2601630562300,376,1858,52,73,6,25,55,2069
377,G2601630562400,377,5084,90,127,15,56,85,5457
378,G2601630562500,378,1723,80,85,2,20,41,1951
379,G2601630562600,379,3486,31,54,7,55,52,3685
380,G2601630562700,380,3260,33,62,13,58,70,3496
381,G2601630562800,381,3231,61,62,1,34,86,3475
382,G2601630562900,382,3127,96,61,21,67,71,3443
383,G2601630563200,383,1942,839,289,13,80,131,3294
384,G2601630563300,384,2087,346,256,2,73,104,2868
385,G2601630563400,385,4300,312,216,8,94,162,5092
386,G2601630563500,386,5097,198,625,9,115,185,6229
387,G2601630563600,387,1687,88,233,8,41,59,2116
388,G2601630563700,388,1220,199,169,0,39,44,1671
389,G2601630563800,389,2407,231,152,5,92,104,2991
390,G2601630563900,390,1777,193,389,3,31,42,2435
391,G2601630564000,391,1269,448,215,11,39,63,2045
392,G2601630564100,392,2693,565,818,15,131,115,4337
393,G2601630564200,393,2915,289,364,6,139,104,3817
394,G2601630564300,394,1956,202,321,5,62,98,2644
395,G2601630564401,395,3983,263,767,13,95,103,5224
396,G2601630564402,396,2565,388,1192,8,99,133,4385
397,G2601630564501,397,3104,294,643,4,99,102,4246
398,G2601630564502,398,2351,365,833,2,87,73,3711
399,G2601630564503,399,2044,772,528,7,87,154,3592
400,G2601630564504,400,3866,680,975,16,147,277,5961
401,G2601630564600,401,4787,354,1180,10,143,204,6678
402,G2601630564700,402,2732,994,987,10,168,138,5029
403,G2601630564800,403,3478,453,491,20,108,126,4676
404,G2601630564900,404,1592,210,17,26,76,165,2086
405,G2601630565000,405,3313,387,1081,5,124,136,5046
406,G2601630565100,406,2216,835,225,6,64,137,3483
407,G2601630565200,407,3157,1109,577,18,68,149,5078
408,G2601630565300,408,2457,2472,365,22,119,165,5600
409,G2601630565600,409,2034,113,42,6,48,56,2299
410,G2601630565700,410,2725,397,184,7,95,148,3556
411,G2601630565800,411,3242,355,44,12,70,158,3881
412,G2601630565900,412,2020,333,50,9,47,121,2580
413,G2601630566400,413,593,349,7,2,17,44,1012
414,G2601630566500,414,1565,431,105,15,63,88,2267
415,G2601630566600,415,1570,440,14,2,57,72,2155
416,G2601630566700,416,3405,275,17,22,115,139,3973
417,G2601630566800,417,2408,442,36,12,83,108,3089
418,G2601630566900,418,3539,1027,187,22,171,151,5097
419,G2601630567000,419,1442,1760,23,22,115,225,3587
420,G2601630567100,420,2935,266,60,18,108,226,3613
421,G2601630567201,421,3157,105,43,10,60,127,3502
422,G2601630567202,422,2268,563,43,9,36,97,3016
423,G2601630567300,423,3848,346,103,11,52,95,4455
424,G2601630567400,424,2511,77,35,9,25,70,2727
425,G2601630567800,425,3798,783,107,18,104,215,5025
426,G2601630567900,426,2552,132,35,35,70,105,2929
427,G2601630568000,427,1825,182,74,12,58,89,2240
428,G2601630568200,428,3383,231,101,14,61,127,3917
429,G2601630568300,429,3375,615,50,34,89,157,4320
430,G2601630568400,430,3363,207,95,16,67,128,3876
431,G2601630568500,431,3294,747,26,44,205,231,4547
432,G2601630568700,432,2536,1050,80,8,134,135,3943
433,G2601630568800,433,1378,1447,80,6,104,112,3127
434,G2601630568900,434,2310,225,97,7,65,92,2796
435,G2601630569100,435,2303,45,8,10,38,95,2499
436,G2601630569200,436,2454,116,22,22,42,131,2787
437,G2601630569300,437,3400,165,42,14,103,137,3861
438,G2601630569400,438,2611,176,31,8,55,66,2947
439,G2601630569500,439,2482,22,8,6,56,88,2662
440,G2601630569600,440,3258,78,26,13,57,95,3527
441,G2601630569700,441,4041,146,45,20,75,136,4463
442,G2601630569800,442,2241,86,15,5,60,92,2499
443,G2601630569900,443,2187,94,39,15,49,63,2447
444,G2601630570100,444,1354,1924,352,19,135,124,3908
445,G2601630570200,445,1020,1518,6,4,96,80,2724
446,G2601630570400,446,1230,3588,8,15,208,137,5186
447,G2601630570500,447,672,2752,19,14,127,148,3732
448,G2601630570600,448,117,1831,4,3,34,20,2009
449,G2601630570800,449,158,2673,13,5,130,43,3022
450,G2601630570900,450,108,2311,4,4,61,47,2535
451,G2601630571000,451,300,1813,7,6,70,54,2250
452,G2601630571500,452,3599,575,95,12,188,116,4585
453,G2601630571600,453,1406,116,36,5,48,61,1672
454,G2601630571700,454,1525,609,42,10,114,101,2401
455,G2601630571800,455,2556,258,69,4,66,168,3121
456,G2601630571900,456,2292,328,55,4,57,116,2852
457,G2601630572000,457,1682,77,20,3,44,73,1899
458,G2601630572100,458,5445,177,100,24,176,255,6177
459,G2601630572200,459,5403,377,118,7,101,225,6231
460,G2601630572400,460,1063,143,18,2,20,93,1339
461,G2601630572500,461,1316,355,26,11,48,114,1870
462,G2601630572600,462,4120,470,78,23,107,391,5189
463,G2601630572700,463,4038,151,73,34,90,230,4616
464,G2601630572800,464,4843,201,38,29,115,418,5644
465,G2601630572900,465,2212,94,17,21,68,203,2615
466,G2601630573000,466,2878,67,54,1,49,61,3110
467,G2601630573100,467,3565,492,165,6,138,87,4453
468,G2601630573300,468,3441,52,62,4,253,88,3900
469,G2601630573400,469,3226,99,53,6,196,122,3702
470,G2601630573500,470,4729,92,112,3,315,64,5315
471,G2601630573600,471,5849,154,55,10,447,137,6652
472,G2601630573701,472,1748,58,26,3,116,39,1990
473,G2601630573702,473,5884,87,39,0,414,100,6524
474,G2601630573800,474,4668,129,54,6,356,93,5306
475,G2601630573900,475,4766,56,107,5,218,156,5308
476,G2601630574000,476,5053,126,119,5,301,155,5759
477,G2601630574100,477,3347,182,64,7,229,126,3955
478,G2601630574202,478,1907,843,104,9,57,88,3008
479,G2601630574300,479,2434,270,229,11,149,147,3240
480,G2601630574600,480,4416,108,50,12,88,239,4913
481,G2601630574700,481,3977,91,45,3,55,220,4391
482,G2601630574800,482,3915,42,47,7,52,170,4233
483,G2601630574900,483,1543,94,51,3,34,51,1776
484,G2601630575000,484,4098,92,91,11,70,227,4589
485,G2601630575100,485,2317,108,48,7,48,121,2649
486,G2601630575200,486,3367,312,73,24,68,215,4059
487,G2601630575300,487,3233,90,31,8,59,170,3591
488,G2601630575400,488,2756,148,44,7,91,207,3253
489,G2601630575500,489,3335,194,53,3,75,226,3886
490,G2601630575600,490,1331,58,32,1,33,84,1539
491,G2601630576000,491,1387,167,56,17,36,182,1845
492,G2601630576100,492,5106,169,47,18,99,643,6082
493,G2601630576200,493,2315,37,14,10,33,201,2610
494,G2601630576300,494,2189,19,29,16,22,155,2430
495,G2601630576400,495,3252,46,14,18,26,265,3621
496,G2601630576500,496,3541,28,21,13,43,256,3902
497,G2601630576600,497,3712,65,20,14,54,304,4169
498,G2601630576700,498,3143,57,29,14,42,268,3553
499,G2601630577000,499,2400,808,26,18,127,952,4331
500,G2601630577100,500,1921,232,17,23,105,635,2933
501,G2601630577200,501,2304,169,35,17,79,584,3188
502,G2601630577300,502,2536,54,11,22,63,400,3086
503,G2601630577400,503,2776,136,13,18,37,528,3508
504,G2601630577500,504,2641,153,12,14,49,428,3297
505,G2601630577600,505,3083,126,12,22,99,448,3790
506,G2601630577700,506,1962,56,13,7,31,301,2370
507,G2601630577800,507,4048,117,16,22,65,676,4944
508,G2601630577900,508,3426,160,22,17,74,377,4076
509,G2601630578000,509,2003,161,14,25,69,347,2619
510,G2601630578500,510,3563,424,56,35,124,951,5153
511,G2601630578600,511,3572,732,28,29,194,1007,5562
512,G2601630579100,512,971,541,14,20,88,247,1881
513,G2601630579200,513,1756,857,4,14,128,536,3295
514,G2601630579300,514,24,2535,1,4,62,101,2727
515,G2601630579500,515,997,458,1,25,57,325,1863
516,G2601630579600,516,40,2962,2,8,56,49,3117
517,G2601630579700,517,1503,589,20,8,120,638,2878
518,G2601630579800,518,936,366,5,17,64,266,1654
519,G2601630579900,519,3776,410,138,11,139,141,4615
520,G2601630580100,520,1840,67,16,11,34,121,2089
521,G2601630580200,521,2632,26,11,16,44,146,2875
522,G2601630580300,522,2579,33,2,13,64,191,2882
523,G2601630580400,523,2460,12,18,12,20,122,2644
524,G2601630580500,524,2741,14,5,12,42,136,2950
525,G2601630580600,525,2810,36,29,29,48,169,3121
526,G2601630580700,526,3405,67,30,15,64,177,3758
527,G2601630580800,527,1400,28,8,12,29,70,1547
528,G2601630580900,528,3695,44,16,26,56,180,4017
529,G2601630581100,529,3120,405,81,20,61,283,3970
530,G2601630581200,530,3117,157,136,9,54,233,3706
531,G2601630581500,531,2023,22,14,6,41,132,2238
532,G2601630581600,532,4420,522,183,23,87,385,5620
533,G2601630581800,533,2416,37,14,21,57,179,2724
534,G2601630581900,534,4348,38,7,13,55,271,4732
535,G2601630582000,535,2324,414,31,10,70,215,3064
536,G2601630582100,536,3621,40,27,14,33,258,3993
537,G2601630583000,537,2252,96,31,16,52,150,2597
538,G2601630583100,538,3629,162,27,15,94,179,4106
539,G2601630583200,539,2568,82,9,16,57,127,2859
540,G2601630583300,540,2261,104,25,13,35,112,2550
541,G2601630583400,541,4498,112,25,33,83,289,5040
542,G2601630583500,542,2487,88,22,16,55,120,2788
543,G2601630583600,543,2333,105,15,18,47,149,2667
544,G2601630583700,544,3167,251,30,17,65,191,3721
545,G2601630583800,545,3696,492,64,19,70,176,4517
546,G2601630583900,546,2632,962,136,17,141,205,4093
547,G2601630584000,547,3014,1059,57,18,98,225,4471
548,G2601630584100,548,1537,47,26,14,28,91,1743
549,G2601630584200,549,2402,956,56,9,69,203,3695
550,G2601630584300,550,1245,446,77,1,42,111,1922
551,G2601630584400,551,2270,482,173,9,83,210,3227
552,G2601630584500,552,1850,463,48,8,67,131,2567
553,G2601630584600,553,1113,386,153,4,66,114,1836
554,G2601630584700,554,2062,173,111,18,44,154,2562
555,G2601630584800,555,2161,3430,42,24,241,272,6170
556,G2601630585500,556,1592,202,8,10,70,70,1952
557,G2601630585600,557,520,2703,70,17,153,82,3545
558,G2601630585700,558,937,877,6,15,96,42,1973
559,G2601630585800,559,1741,2434,36,21,168,114,4514
560,G2601630585900,560,1945,1115,16,13,108,75,3272
561,G2601630586200,561,3238,2800,120,29,239,258,6684
562,G2601630586300,562,1770,120,12,13,36,89,2040
563,G2601630587000,563,3132,553,31,14,110,153,3993
564,G2601630587900,564,3349,2496,350,33,194,129,6551
565,G2601630588000,565,3350,1751,137,44,165,183,5630
566,G2601630588100,566,2040,276,40,18,50,104,2528
567,G2601630588200,567,1636,1396,53,9,120,98,3312
568,G2601630588300,568,4322,759,57,23,121,157,5439
569,G2601630588400,569,3456,1537,92,5,154,115,5359
570,G2601630589300,570,3089,409,4,21,103,84,3710
571,G2601630589400,571,4750,724,19,20,159,167,5839
572,G2601630590400,572,6480,196,40,43,156,236,7151
573,G2601630590500,573,5747,111,39,43,149,189,6278
574,G2601630590600,574,2188,91,36,16,42,77,2450
575,G2601630591501,575,2275,571,235,10,80,147,3318
576,G2601630591502,576,2254,261,399,12,51,117,3094
577,G2601630591600,577,1409,240,98,1,41,123,1912
578,G2601630591700,578,5189,413,281,14,105,319,6321
579,G2601630591800,579,4721,499,351,21,171,405,6168
580,G2601630591900,580,4723,300,98,22,62,258,5463
581,G2601630592000,581,3610,331,119,18,49,224,4351
582,G2601630593000,582,4675,385,123,19,119,261,5582
583,G2601630593200,583,3361,165,110,1,41,256,3934
584,G2601630593300,584,2931,123,64,11,41,189,3359
585,G2601630594000,585,2409,42,8,6,33,92,2590
586,G2601630594100,586,4136,14,40,23,53,122,4388
587,G2601630594200,587,2390,1,13,14,30,73,2521
588,G2601630594300,588,3114,5,14,15,19,106,3273
589,G2601630594400,589,2585,44,33,20,58,115,2855
590,G2601630594500,590,2915,145,27,11,38,90,3226
591,G2601630595000,591,3564,49,44,24,38,170,3889
592,G2601630595100,592,4995,231,126,20,58,219,5649
593,G2601630595200,593,2674,100,27,4,20,123,2948
594,G2601630596100,594,3449,7,73,13,29,85,3656
595,G2601630596200,595,3831,21,106,13,33,106,4110
596,G2601630596300,596,2406,11,67,8,32,81,2605
597,G2601630597000,597,4314,92,39,16,58,137,4656
598,G2601630598000,598,3047,53,29,28,43,89,3289
599,G2601630599000,599,4722,259,68,21,156,258,5484
600,G2601630599100,600,3949,141,16,17,93,178,4394
601,G2601630985000,601,11,13,0,0,0,20,44
602,G2601630985100,602,26,94,0,1,1,1,123
603,G2601630985300,604,2,1,1,0,0,0,4
604,G2601630985500,606,5,5,1,0,0,0,11
