"","X","GISJOIN_T","whites","blacks","asians","latino","native_americans","others","tot"
"1",1,"G2601630000000",0,0,0,0,0,0,0
"2",2,"G2601630500100",1379,2735,42,59,5,108,4328
"3",3,"G2601630500200",780,2403,58,33,12,82,3368
"4",4,"G2601630500300",660,3659,117,45,13,112,4606
"5",5,"G2601630500400",172,4228,27,26,6,58,4517
"6",6,"G2601630500500",141,3678,14,24,16,34,3907
"7",7,"G2601630500600",426,5494,76,49,7,71,6123
"8",8,"G2601630500700",1169,3394,23,63,3,118,4770
"9",9,"G2601630500800",858,1549,39,50,6,95,2597
"10",10,"G2601630500900",485,3975,64,48,3,72,4647
"11",11,"G2601630501000",243,3707,40,28,6,69,4093
"12",12,"G2601630501100",208,4878,12,38,7,48,5191
"13",13,"G2601630501200",115,3008,5,21,4,52,3205
"14",14,"G2601630501300",251,5339,9,30,13,65,5707
"15",15,"G2601630501400",721,3612,14,46,10,86,4489
"16",16,"G2601630501500",1917,2106,93,55,9,88,4268
"17",17,"G2601630501600",1166,826,15,46,9,48,2110
"18",18,"G2601630501700",1566,1099,22,55,22,76,2840
"19",19,"G2601630501800",1690,3352,48,71,12,138,5311
"20",20,"G2601630501900",342,3611,12,31,4,64,4064
"21",21,"G2601630502000",144,3187,2,32,7,71,3443
"22",22,"G2601630503100",528,2715,46,23,13,55,3380
"23",23,"G2601630503200",604,4231,115,42,9,102,5103
"24",24,"G2601630503300",491,4926,245,20,14,76,5772
"25",25,"G2601630503400",300,1884,528,26,9,90,2837
"26",26,"G2601630503500",301,5669,310,47,15,93,6435
"27",27,"G2601630503600",229,2522,418,24,8,101,3302
"28",28,"G2601630503700",118,2189,320,53,8,86,2774
"29",29,"G2601630503900",132,3965,31,40,6,62,4236
"30",30,"G2601630504000",79,2378,1,24,3,45,2530
"31",31,"G2601630504100",108,2902,2,15,3,39,3069
"32",32,"G2601630504200",52,4089,1,18,4,44,4208
"33",33,"G2601630504300",104,3997,7,14,1,59,4182
"34",34,"G2601630504400",94,3621,2,21,7,52,3797
"35",35,"G2601630504500",30,472,0,1,0,3,506
"36",36,"G2601630504600",38,1532,0,23,4,32,1629
"37",37,"G2601630504700",52,3321,2,13,3,41,3432
"38",38,"G2601630504800",111,1933,0,13,5,28,2090
"39",39,"G2601630504900",256,3755,19,17,13,45,4105
"40",40,"G2601630505000",119,1790,22,15,1,38,1985
"41",41,"G2601630505100",391,3938,3,24,5,78,4439
"42",42,"G2601630505200",191,4207,5,23,10,59,4495
"43",43,"G2601630505300",72,3064,6,10,6,31,3189
"44",44,"G2601630506100",334,1891,78,15,2,82,2402
"45",45,"G2601630506200",165,2668,9,19,4,47,2912
"46",46,"G2601630506300",197,3055,81,26,10,61,3430
"47",47,"G2601630506400",744,3276,24,99,18,41,4202
"48",48,"G2601630506500",116,2904,1,23,9,46,3099
"49",49,"G2601630506600",206,3924,8,18,6,52,4214
"50",50,"G2601630506700",160,1367,16,0,10,26,1579
"51",51,"G2601630506800",349,4077,10,34,6,52,4528
"52",52,"G2601630506900",242,4322,10,37,4,72,4687
"53",53,"G2601630507000",24,3200,8,19,2,57,3310
"54",54,"G2601630507100",38,3345,5,9,4,45,3446
"55",55,"G2601630507200",27,1969,1,21,1,24,2043
"56",56,"G2601630507300",70,3945,4,31,10,49,4109
"57",57,"G2601630507400",154,3912,7,36,4,56,4169
"58",58,"G2601630507500",177,2922,7,17,2,40,3165
"59",59,"G2601630507600",400,2334,10,23,16,118,2901
"60",60,"G2601630507700",60,1522,11,6,3,27,1629
"61",61,"G2601630507800",161,1213,1,15,8,29,1427
"62",62,"G2601630507900",1305,3074,43,82,19,411,4934
"63",63,"G2601630508000",810,1369,6,21,7,313,2526
"64",64,"G2601630510200",370,2297,14,28,3,149,2861
"65",65,"G2601630510300",144,1519,1,7,0,40,1711
"66",66,"G2601630510400",43,2300,3,34,19,28,2427
"67",67,"G2601630510500",940,2007,1167,40,35,542,4731
"68",68,"G2601630510600",1572,1374,503,62,4,425,3940
"69",69,"G2601630510700",543,806,113,38,5,465,1970
"70",70,"G2601630510800",135,1602,5,27,5,63,1837
"71",71,"G2601630510900",74,1992,27,20,3,35,2151
"72",72,"G2601630511100",0,8,0,0,0,0,8
"73",73,"G2601630511200",11,1996,1,12,1,20,2041
"74",74,"G2601630511500",49,1905,17,25,8,43,2047
"75",75,"G2601630511600",91,3012,4,34,10,66,3217
"76",76,"G2601630511700",7,748,0,3,0,3,761
"77",77,"G2601630512100",110,4905,3,36,43,85,5182
"78",78,"G2601630512200",43,1614,2,14,4,21,1698
"79",79,"G2601630512300",55,1875,9,13,4,25,1981
"80",80,"G2601630512400",54,2413,1,40,1,36,2545
"81",81,"G2601630512600",139,2839,2,9,3,36,3028
"82",82,"G2601630512900",207,2672,7,52,9,51,2998
"83",83,"G2601630513200",351,2324,11,34,6,67,2793
"84",84,"G2601630513300",441,2030,20,18,3,62,2574
"85",85,"G2601630513400",50,2697,18,9,4,43,2821
"86",86,"G2601630513500",66,588,6,7,5,9,681
"87",87,"G2601630513600",148,2496,3,9,7,26,2689
"88",88,"G2601630513900",54,4054,2,24,28,42,4204
"89",89,"G2601630514000",31,279,0,1,1,0,312
"90",90,"G2601630514100",48,5028,10,17,6,42,5151
"91",91,"G2601630514300",38,4037,2,21,5,47,4150
"92",92,"G2601630514500",8,1759,0,17,11,17,1812
"93",93,"G2601630514600",19,1786,0,15,3,25,1848
"94",94,"G2601630514700",17,1664,1,8,3,13,1706
"95",95,"G2601630514800",24,1203,0,9,10,15,1261
"96",96,"G2601630514900",17,2164,2,11,5,26,2225
"97",97,"G2601630515000",17,2392,1,18,6,21,2455
"98",98,"G2601630515100",61,2087,6,12,6,13,2185
"99",99,"G2601630515200",222,3105,6,17,3,25,3378
"100",100,"G2601630515300",359,2760,26,46,5,55,3251
"101",101,"G2601630515400",522,1019,9,23,5,49,1627
"102",102,"G2601630515600",45,2177,1,15,4,24,2266
"103",103,"G2601630515700",904,2855,21,42,10,72,3904
"104",104,"G2601630515800",9,61,0,0,0,0,70
"105",105,"G2601630516100",20,1360,0,6,5,9,1400
"106",106,"G2601630516200",54,1547,1,8,2,13,1625
"107",107,"G2601630516300",103,1327,0,10,2,13,1455
"108",108,"G2601630516400",162,1513,4,12,5,26,1722
"109",109,"G2601630516500",359,1028,37,38,1,37,1500
"110",110,"G2601630516600",10,2220,2,23,1,27,2283
"111",111,"G2601630516700",40,2779,1,20,5,30,2875
"112",112,"G2601630516800",30,1744,0,21,7,30,1832
"113",113,"G2601630516900",130,1949,3,12,11,39,2144
"114",114,"G2601630517000",575,1523,62,33,7,58,2258
"115",115,"G2601630517100",162,1119,10,13,1,28,1333
"116",116,"G2601630517200",592,2246,14,36,2,31,2921
"117",117,"G2601630517400",77,380,0,4,2,8,471
"118",118,"G2601630517500",231,2229,105,24,7,41,2637
"119",119,"G2601630517600",17,1690,9,16,7,15,1754
"120",120,"G2601630517700",26,100,2,3,0,2,133
"121",121,"G2601630517800",40,1696,5,6,0,17,1764
"122",122,"G2601630517900",0,0,0,0,0,0,0
"123",123,"G2601630518000",529,1263,48,31,4,44,1919
"124",124,"G2601630518100",33,226,3,1,3,8,274
"125",125,"G2601630518400",272,1141,14,16,6,66,1515
"126",126,"G2601630518500",324,1732,2,11,2,38,2109
"127",127,"G2601630518600",24,1457,0,7,6,21,1515
"128",128,"G2601630518800",57,1743,2,9,2,14,1827
"129",129,"G2601630520100",95,78,3,5,1,6,188
"130",130,"G2601630520200",855,672,752,73,3,55,2410
"131",131,"G2601630520300",545,1304,221,65,5,71,2211
"132",132,"G2601630520400",411,1077,126,38,10,62,1724
"133",133,"G2601630520500",66,1716,9,28,5,14,1838
"134",134,"G2601630520600",401,1377,21,42,33,39,1913
"135",135,"G2601630520700",350,1447,13,49,8,52,1919
"136",136,"G2601630520800",348,825,57,39,3,29,1301
"137",137,"G2601630520900",5,40,1,0,1,2,49
"138",138,"G2601630521100",273,394,5,1285,23,32,2012
"139",139,"G2601630521300",109,749,0,85,1,11,955
"140",140,"G2601630521400",475,435,4,305,9,25,1253
"141",141,"G2601630521500",386,1307,3,132,7,61,1896
"142",142,"G2601630521800",3,201,0,0,0,1,205
"143",143,"G2601630521900",635,2384,21,60,10,79,3189
"144",144,"G2601630522000",112,1484,2,48,8,24,1678
"145",145,"G2601630522100",19,1799,0,34,1,18,1871
"146",146,"G2601630522200",50,1260,0,20,4,30,1364
"147",147,"G2601630522300",51,2549,2,28,5,27,2662
"148",148,"G2601630522400",50,1450,9,48,1,18,1576
"149",149,"G2601630523100",472,207,18,1205,11,43,1956
"150",150,"G2601630523200",1089,263,16,3200,24,83,4675
"151",151,"G2601630523300",679,136,20,3034,9,55,3933
"152",152,"G2601630523400",659,359,14,1775,20,59,2886
"153",153,"G2601630523500",389,209,4,465,19,27,1113
"154",154,"G2601630523600",224,696,0,212,2,26,1160
"155",155,"G2601630523700",834,399,0,605,12,41,1891
"156",156,"G2601630523800",1706,422,26,3239,39,111,5543
"157",157,"G2601630524000",1062,175,24,2124,19,53,3457
"158",158,"G2601630524100",1446,183,25,2957,60,156,4827
"159",159,"G2601630524200",1970,282,31,3261,49,194,5787
"160",160,"G2601630524300",1326,183,4,1588,52,83,3236
"161",161,"G2601630524500",803,255,24,479,3,32,1596
"162",162,"G2601630524700",31,5123,2,76,6,44,5282
"163",163,"G2601630524800",41,3494,10,36,12,44,3637
"164",164,"G2601630525100",11,1889,3,30,3,20,1956
"165",165,"G2601630525200",22,1810,2,17,2,39,1892
"166",166,"G2601630525300",4,823,4,1,0,10,842
"167",167,"G2601630525400",378,2131,81,539,8,42,3179
"168",168,"G2601630525500",172,1186,26,303,1,32,1720
"169",169,"G2601630525600",751,303,30,1180,7,49,2320
"170",170,"G2601630525700",1950,338,96,2845,28,138,5395
"171",171,"G2601630525800",950,331,23,1152,13,99,2568
"172",172,"G2601630526000",1453,290,18,1316,26,298,3401
"173",173,"G2601630526100",1624,178,29,540,11,432,2814
"174",174,"G2601630526200",1511,534,15,971,27,491,3549
"175",175,"G2601630526300",1245,1059,51,2236,30,191,4812
"176",176,"G2601630526400",364,886,17,860,12,31,2170
"177",177,"G2601630526500",65,3412,0,23,12,45,3557
"178",178,"G2601630530100",28,4018,0,32,13,81,4172
"179",179,"G2601630530200",590,4431,44,85,6,72,5228
"180",180,"G2601630530300",25,2617,12,43,17,25,2739
"181",181,"G2601630530400",9,2187,0,29,4,16,2245
"182",182,"G2601630530500",13,2896,7,16,2,31,2965
"183",183,"G2601630530700",38,2954,12,14,1,30,3049
"184",184,"G2601630530800",31,3409,3,18,6,24,3491
"185",185,"G2601630531000",5,1592,1,5,8,17,1628
"186",186,"G2601630531100",49,1835,2,6,9,42,1943
"187",187,"G2601630531200",79,3340,3,17,9,59,3507
"188",188,"G2601630531300",7,1897,0,4,5,15,1928
"189",189,"G2601630531400",8,2470,2,5,1,27,2513
"190",190,"G2601630531500",29,4441,6,7,5,56,4544
"191",191,"G2601630531600",13,2621,8,30,13,35,2720
"192",192,"G2601630531700",17,2695,1,8,7,61,2789
"193",193,"G2601630531800",22,3561,5,12,6,26,3632
"194",194,"G2601630531900",61,1881,8,16,3,29,1998
"195",195,"G2601630532200",48,2194,2,7,3,45,2299
"196",196,"G2601630532300",169,1115,5,22,2,36,1349
"197",197,"G2601630532400",108,2150,5,15,8,48,2334
"198",198,"G2601630532500",165,2782,16,26,4,76,3069
"199",199,"G2601630532600",373,2796,188,40,6,58,3461
"200",200,"G2601630532700",15,1744,2,13,4,19,1797
"201",201,"G2601630533000",83,2396,4,12,3,28,2526
"202",202,"G2601630533100",12,2449,5,21,4,64,2555
"203",203,"G2601630533200",13,2992,6,9,2,25,3047
"204",204,"G2601630533300",49,2912,9,19,7,41,3037
"205",205,"G2601630533400",33,4478,4,32,11,73,4631
"206",206,"G2601630533500",5,1969,0,19,4,7,2004
"207",207,"G2601630533600",17,3929,1,27,8,41,4023
"208",208,"G2601630533700",14,1865,2,6,2,38,1927
"209",209,"G2601630534100",17,2853,6,15,6,42,2939
"210",210,"G2601630534200",51,5810,5,50,8,71,5995
"211",211,"G2601630534300",35,2444,3,15,3,24,2524
"212",212,"G2601630534400",44,3043,1,33,2,45,3168
"213",213,"G2601630534500",19,1741,4,8,1,25,1798
"214",214,"G2601630534600",23,2889,2,28,6,37,2985
"215",215,"G2601630534700",71,3666,7,22,4,45,3815
"216",216,"G2601630535000",108,3584,9,33,8,55,3797
"217",217,"G2601630535100",63,2645,3,22,8,44,2785
"218",218,"G2601630535200",49,3345,2,46,2,22,3466
"219",219,"G2601630535300",98,4673,3,24,11,80,4889
"220",220,"G2601630535400",42,2030,7,10,3,15,2107
"221",221,"G2601630535500",95,3303,5,33,5,63,3504
"222",222,"G2601630535600",169,3561,11,36,9,30,3816
"223",223,"G2601630535700",34,1899,0,13,1,24,1971
"224",224,"G2601630536100",68,5100,7,35,12,78,5300
"225",225,"G2601630536200",27,2352,2,15,0,16,2412
"226",226,"G2601630536300",44,4708,0,33,10,62,4857
"227",227,"G2601630536400",19,4181,7,24,4,18,4253
"228",228,"G2601630536500",18,2901,1,15,8,43,2986
"229",229,"G2601630536600",29,4380,2,28,12,52,4503
"230",230,"G2601630536700",17,1773,1,19,9,13,1832
"231",231,"G2601630536800",14,2200,1,7,0,13,2235
"232",232,"G2601630536900",31,4091,1,23,14,47,4207
"233",233,"G2601630537000",91,4443,3,48,6,75,4666
"234",234,"G2601630537100",39,2947,3,46,8,38,3081
"235",235,"G2601630537200",15,1460,1,13,7,21,1517
"236",236,"G2601630537300",73,4080,1,6,3,47,4210
"237",237,"G2601630537500",46,3743,2,22,11,42,3866
"238",238,"G2601630537600",47,3741,6,33,8,65,3900
"239",239,"G2601630537700",65,4147,3,11,4,49,4279
"240",240,"G2601630537800",60,2735,5,12,2,44,2858
"241",241,"G2601630538100",347,1969,11,25,2,46,2400
"242",242,"G2601630538200",274,1848,8,12,3,35,2180
"243",243,"G2601630538300",210,3104,7,36,15,86,3458
"244",244,"G2601630538400",419,3317,58,47,7,104,3952
"245",245,"G2601630538500",37,5905,6,25,5,108,6086
"246",246,"G2601630538600",53,5434,4,36,18,85,5630
"247",247,"G2601630538700",25,3895,13,21,6,52,4012
"248",248,"G2601630538800",12,1610,3,21,0,17,1663
"249",249,"G2601630538900",50,3535,1,23,9,60,3678
"250",250,"G2601630539000",26,3348,6,11,1,41,3433
"251",251,"G2601630539100",11,2142,3,3,2,38,2199
"252",252,"G2601630539200",51,5046,8,53,10,67,5235
"253",253,"G2601630539300",58,3985,5,19,8,42,4117
"254",254,"G2601630539400",54,3825,3,28,9,60,3979
"255",255,"G2601630539500",62,3008,6,11,7,44,3138
"256",256,"G2601630539600",45,3324,11,20,8,61,3469
"257",257,"G2601630539700",40,2167,4,17,1,31,2260
"258",258,"G2601630540100",123,3952,7,25,12,93,4212
"259",259,"G2601630540200",91,4827,4,26,5,43,4996
"260",260,"G2601630540300",72,4347,7,37,12,46,4521
"261",261,"G2601630540400",86,3230,14,13,13,58,3414
"262",262,"G2601630540500",150,3753,9,33,5,44,3994
"263",263,"G2601630540600",129,3963,4,28,2,68,4194
"264",264,"G2601630540700",167,4183,3,19,9,78,4459
"265",265,"G2601630540800",84,2591,12,13,3,31,2734
"266",266,"G2601630540900",124,3852,10,21,11,48,4066
"267",267,"G2601630541000",154,4602,12,34,4,62,4868
"268",268,"G2601630541100",235,5089,5,55,14,79,5477
"269",269,"G2601630541200",358,2840,17,28,12,99,3354
"270",270,"G2601630541300",1217,1348,48,84,20,74,2791
"271",271,"G2601630541400",783,2271,9,42,7,73,3185
"272",272,"G2601630541500",249,4088,22,52,14,134,4559
"273",273,"G2601630541700",130,2170,21,27,5,55,2408
"274",274,"G2601630541800",1009,1494,109,32,13,95,2752
"275",275,"G2601630542100",99,5036,3,26,13,79,5256
"276",276,"G2601630542200",113,4505,4,23,9,77,4731
"277",277,"G2601630542300",78,2798,2,28,2,49,2957
"278",278,"G2601630542400",73,3221,3,19,7,35,3358
"279",279,"G2601630542500",133,2653,1,18,6,55,2866
"280",280,"G2601630542600",41,3725,5,26,2,43,3842
"281",281,"G2601630542700",56,1411,0,18,2,31,1518
"282",282,"G2601630542800",111,2742,6,9,10,43,2921
"283",283,"G2601630542900",374,3371,16,27,9,87,3884
"284",284,"G2601630543000",359,1803,13,13,5,29,2222
"285",285,"G2601630543100",352,2390,31,12,2,59,2846
"286",286,"G2601630543200",201,3119,9,20,7,63,3419
"287",287,"G2601630543400",177,3661,4,33,11,58,3944
"288",288,"G2601630543500",278,2316,10,55,22,41,2722
"289",289,"G2601630543600",549,2525,12,50,22,96,3254
"290",290,"G2601630543700",288,3056,5,28,6,62,3445
"291",291,"G2601630543800",439,1598,21,46,9,39,2152
"292",292,"G2601630543900",290,1151,3,30,4,33,1511
"293",293,"G2601630544000",504,1850,259,39,18,65,2735
"294",294,"G2601630544100",323,2290,6,33,6,49,2707
"295",295,"G2601630544200",869,2737,24,72,23,114,3839
"296",296,"G2601630544300",1481,1664,22,48,21,116,3352
"297",297,"G2601630545100",115,2635,2,11,10,55,2828
"298",298,"G2601630545200",101,4690,1,16,15,43,4866
"299",299,"G2601630545300",130,3218,0,13,2,40,3403
"300",300,"G2601630545400",86,641,0,5,3,14,749
"301",301,"G2601630545500",1484,2494,16,174,21,400,4589
"302",302,"G2601630545600",2911,740,66,374,17,886,4994
"303",303,"G2601630545700",1752,346,72,315,12,164,2661
"304",304,"G2601630545800",3333,825,94,493,24,373,5142
"305",305,"G2601630545900",1786,2291,26,304,31,232,4670
"306",306,"G2601630546000",543,4439,12,99,7,78,5178
"307",307,"G2601630546100",1156,3580,41,185,10,100,5072
"308",308,"G2601630546200",2323,238,120,194,13,40,2928
"309",309,"G2601630546300",407,1400,58,33,6,37,1941
"310",310,"G2601630546400",125,1572,1,12,3,25,1738
"311",311,"G2601630546500",164,2366,11,5,4,41,2591
"312",312,"G2601630546600",235,2492,5,27,6,71,2836
"313",313,"G2601630546700",231,3773,2,21,8,62,4097
"314",314,"G2601630546800",181,4322,4,40,5,64,4616
"315",315,"G2601630546900",39,1342,2,16,7,18,1424
"316",316,"G2601630550100",3817,124,77,53,13,79,4163
"317",317,"G2601630550200",4089,186,122,117,19,146,4679
"318",318,"G2601630550300",3439,52,25,47,9,29,3601
"319",319,"G2601630550400",1610,26,24,37,0,15,1712
"320",320,"G2601630550500",3839,18,36,46,4,15,3958
"321",321,"G2601630550600",2611,15,28,27,8,11,2700
"322",322,"G2601630550700",5342,36,66,63,3,26,5536
"323",323,"G2601630550800",1476,9,16,18,0,9,1528
"324",324,"G2601630550900",2537,16,109,49,5,27,2743
"325",325,"G2601630551100",5068,30,68,23,1,21,5211
"326",326,"G2601630551200",3890,37,56,54,0,38,4075
"327",327,"G2601630551300",3508,208,93,52,13,36,3910
"328",328,"G2601630551400",3145,824,83,69,6,66,4193
"329",329,"G2601630551500",2061,242,12,23,14,34,2386
"330",330,"G2601630551600",3385,175,54,80,12,59,3765
"331",331,"G2601630551700",3510,8,147,37,7,45,3754
"332",332,"G2601630551800",3842,31,82,53,2,30,4040
"333",333,"G2601630552000",2003,118,272,23,5,310,2731
"334",334,"G2601630552100",2898,927,492,72,26,462,4877
"335",335,"G2601630552200",2748,191,368,44,12,379,3742
"336",336,"G2601630552300",2419,259,477,44,10,476,3685
"337",337,"G2601630552400",1107,816,322,38,9,371,2663
"338",338,"G2601630552600",2448,633,469,76,26,886,4538
"339",339,"G2601630552700",249,486,0,3,0,2,740
"340",340,"G2601630553000",137,1540,8,10,5,24,1724
"341",341,"G2601630553100",154,2446,8,8,5,61,2682
"342",342,"G2601630553200",32,1691,6,5,0,14,1748
"343",343,"G2601630553300",30,2028,9,7,3,28,2105
"344",344,"G2601630553400",49,1754,1,9,5,31,1849
"345",345,"G2601630553600",150,3150,4,31,7,104,3446
"346",346,"G2601630553800",116,2989,8,25,14,40,3192
"347",347,"G2601630554100",4031,197,41,91,21,94,4475
"348",348,"G2601630554200",3173,69,32,91,31,80,3476
"349",349,"G2601630554300",5295,114,20,88,20,80,5617
"350",350,"G2601630554400",3445,105,25,58,22,62,3717
"351",351,"G2601630554500",2785,197,33,71,22,63,3171
"352",352,"G2601630554600",3810,81,11,62,15,37,4016
"353",353,"G2601630554700",2622,80,10,44,3,22,2781
"354",354,"G2601630554800",2760,852,44,76,11,72,3815
"355",355,"G2601630554900",2922,296,26,89,10,57,3400
"356",356,"G2601630555100",4422,94,51,108,12,70,4757
"357",357,"G2601630555300",2932,365,27,90,11,67,3492
"358",358,"G2601630555400",1337,1519,32,78,8,66,3040
"359",359,"G2601630555500",2555,355,32,60,17,53,3072
"360",360,"G2601630555600",2642,59,10,38,8,36,2793
"361",361,"G2601630556100",3513,59,91,58,15,67,3803
"362",362,"G2601630556200",2639,53,124,71,8,36,2931
"363",363,"G2601630556300",2780,33,74,51,2,28,2968
"364",364,"G2601630556400",4088,114,225,85,1,76,4589
"365",365,"G2601630556500",2070,23,49,20,3,34,2199
"366",366,"G2601630556600",3659,20,65,42,6,28,3820
"367",367,"G2601630556700",2570,17,65,34,2,14,2702
"368",368,"G2601630556800",1777,16,22,49,0,6,1870
"369",369,"G2601630556900",3488,26,129,59,10,47,3759
"370",370,"G2601630557000",2806,95,120,100,13,45,3179
"371",371,"G2601630557100",2442,72,61,49,12,48,2684
"372",372,"G2601630557200",2006,20,16,43,7,13,2105
"373",373,"G2601630557300",1972,15,23,23,3,21,2057
"374",374,"G2601630557400",3448,4,37,50,3,42,3584
"375",375,"G2601630557500",3954,21,86,49,3,26,4139
"376",376,"G2601630557600",3294,15,94,72,5,26,3506
"377",377,"G2601630557700",4658,4,52,42,2,26,4784
"378",378,"G2601630557900",5264,55,57,65,11,53,5505
"379",379,"G2601630558000",4325,9,71,71,16,60,4552
"380",380,"G2601630558100",3569,15,56,85,4,17,3746
"381",381,"G2601630558200",4191,55,84,99,8,35,4472
"382",382,"G2601630558300",1858,22,16,47,16,30,1989
"383",383,"G2601630558400",3499,40,78,58,5,38,3718
"384",384,"G2601630558500",3971,46,58,37,2,43,4157
"385",385,"G2601630558600",1983,20,49,36,4,30,2122
"386",386,"G2601630558700",2776,3,33,64,2,33,2911
"387",387,"G2601630558800",2805,11,28,53,9,20,2926
"388",388,"G2601630558900",1888,9,26,33,7,22,1985
"389",389,"G2601630559000",2687,15,17,62,10,42,2833
"390",390,"G2601630559100",2614,28,20,68,9,32,2771
"391",391,"G2601630559200",2057,10,31,56,9,16,2179
"392",392,"G2601630560100",2978,10,38,52,3,26,3107
"393",393,"G2601630560200",4707,113,335,143,3,59,5360
"394",394,"G2601630560300",3315,311,274,63,13,54,4030
"395",395,"G2601630560400",6020,36,145,62,2,58,6323
"396",396,"G2601630560700",4128,22,142,65,7,55,4419
"397",397,"G2601630560900",368,432,1,39,22,42,904
"398",398,"G2601630561600",3885,15,47,50,12,50,4059
"399",399,"G2601630561700",2186,549,23,85,16,65,2924
"400",400,"G2601630561900",5349,105,345,105,4,70,5978
"401",401,"G2601630562300",1857,24,66,36,3,20,2006
"402",402,"G2601630562400",5368,47,126,78,15,48,5682
"403",403,"G2601630562500",2029,19,21,37,8,27,2141
"404",404,"G2601630562600",3194,20,35,45,6,43,3343
"405",405,"G2601630562700",3393,12,44,36,17,36,3538
"406",406,"G2601630562800",3431,35,75,41,10,50,3642
"407",407,"G2601630562900",3289,34,77,60,12,35,3507
"408",408,"G2601630563200",2632,354,327,84,17,79,3493
"409",409,"G2601630563300",2515,178,189,81,9,76,3048
"410",410,"G2601630563400",4724,134,242,92,14,78,5284
"411",411,"G2601630563500",5587,183,665,94,13,94,6636
"412",412,"G2601630563600",1900,31,205,59,4,33,2232
"413",413,"G2601630563700",1448,82,147,34,0,56,1767
"414",414,"G2601630563800",2693,97,154,78,5,50,3077
"415",415,"G2601630563900",2032,88,322,48,5,50,2545
"416",416,"G2601630564000",1392,91,131,66,11,37,1728
"417",417,"G2601630564100",2878,138,481,106,10,88,3701
"418",418,"G2601630564200",3489,119,236,115,7,67,4033
"419",419,"G2601630564300",2135,112,194,68,8,30,2547
"420",420,"G2601630564400",4044,163,507,80,1,67,4862
"421",421,"G2601630564500",7786,706,1012,210,39,199,9952
"422",422,"G2601630564600",5068,222,602,126,3,105,6126
"423",423,"G2601630564700",3412,256,606,150,15,167,4606
"424",424,"G2601630564800",3782,223,253,118,26,64,4466
"425",425,"G2601630564900",1702,85,19,69,6,42,1923
"426",426,"G2601630565000",3627,172,356,110,12,63,4340
"427",427,"G2601630565100",2106,172,39,52,8,74,2451
"428",428,"G2601630565200",4028,527,575,124,6,90,5350
"429",429,"G2601630565300",3782,729,254,165,20,121,5071
"430",430,"G2601630565400",3900,525,461,158,19,157,5220
"431",431,"G2601630565500",901,26,17,10,4,23,981
"432",432,"G2601630565600",2399,66,35,55,5,35,2595
"433",433,"G2601630565700",2976,196,127,88,9,72,3468
"434",434,"G2601630565800",3929,112,48,101,13,52,4255
"435",435,"G2601630565900",2399,114,57,70,8,48,2696
"436",436,"G2601630566400",942,251,19,28,4,36,1280
"437",437,"G2601630566500",2064,195,101,54,13,68,2495
"438",438,"G2601630566600",1755,383,27,36,12,27,2240
"439",439,"G2601630566700",3885,105,23,82,22,87,4204
"440",440,"G2601630566800",2808,250,15,67,29,33,3202
"441",441,"G2601630566900",4365,961,98,102,26,78,5630
"442",442,"G2601630567000",2065,1311,10,60,18,93,3557
"443",443,"G2601630567100",3560,97,69,167,31,108,4032
"444",444,"G2601630567200",6150,340,135,168,26,74,6893
"445",445,"G2601630567300",4286,123,133,104,7,126,4779
"446",446,"G2601630567400",2856,33,39,52,7,29,3016
"447",447,"G2601630567800",4506,242,122,133,35,105,5143
"448",448,"G2601630567900",2910,50,31,61,26,49,3127
"449",449,"G2601630568000",2072,120,35,36,8,38,2309
"450",450,"G2601630568200",3821,122,46,83,11,76,4159
"451",451,"G2601630568300",3928,187,33,70,18,83,4319
"452",452,"G2601630568400",3670,47,52,71,20,46,3906
"453",453,"G2601630568500",4935,203,40,188,54,126,5546
"454",454,"G2601630568700",2937,481,94,122,7,88,3729
"455",455,"G2601630569100",2559,2,12,55,5,26,2659
"456",456,"G2601630569200",2877,36,23,70,13,18,3037
"457",457,"G2601630569300",3814,59,29,77,17,54,4050
"458",458,"G2601630569400",2983,50,37,55,10,48,3183
"459",459,"G2601630569500",2953,20,8,89,8,35,3113
"460",460,"G2601630569600",3725,36,26,53,23,34,3897
"461",461,"G2601630569700",4429,54,38,100,23,40,4684
"462",462,"G2601630569800",2503,37,25,65,9,41,2680
"463",463,"G2601630569900",2595,36,14,47,4,48,2744
"464",464,"G2601630570100",1831,1451,909,103,11,151,4456
"465",465,"G2601630570200",1831,1047,4,94,24,78,3078
"466",466,"G2601630570400",1990,3560,37,96,31,228,5942
"467",467,"G2601630570500",1175,2812,48,73,13,106,4227
"468",468,"G2601630570600",52,2508,6,37,5,48,2656
"469",469,"G2601630570800",92,3624,11,36,21,95,3879
"470",470,"G2601630570900",125,2892,6,9,3,76,3111
"471",471,"G2601630571000",283,2373,5,34,3,68,2766
"472",472,"G2601630571500",3425,209,136,141,7,266,4184
"473",473,"G2601630571600",1456,28,21,58,4,57,1624
"474",474,"G2601630571700",1839,238,48,94,4,101,2324
"475",475,"G2601630571800",2864,23,20,121,9,55,3092
"476",476,"G2601630571900",2699,128,60,66,4,65,3022
"477",477,"G2601630572000",1706,0,25,42,7,59,1839
"478",478,"G2601630572100",5594,23,115,216,22,114,6084
"479",479,"G2601630572200",5676,90,116,183,14,139,6218
"480",480,"G2601630572400",1271,41,24,43,8,31,1418
"481",481,"G2601630572500",1710,135,7,80,13,36,1981
"482",482,"G2601630572600",4933,46,85,294,18,110,5486
"483",483,"G2601630572700",4614,15,47,167,40,64,4947
"484",484,"G2601630572800",5641,27,56,237,27,74,6062
"485",485,"G2601630572900",2574,6,35,93,9,53,2770
"486",486,"G2601630573000",2658,13,78,44,5,122,2920
"487",487,"G2601630573100",3372,202,420,95,5,199,4293
"488",488,"G2601630573300",2876,19,56,152,10,592,3705
"489",489,"G2601630573400",3797,64,53,147,6,464,4531
"490",490,"G2601630573500",3662,65,138,81,9,1259,5214
"491",491,"G2601630573600",5085,97,69,191,15,1518,6975
"492",492,"G2601630573700",6437,79,107,189,7,1584,8403
"493",493,"G2601630573800",4434,82,26,113,6,899,5560
"494",494,"G2601630573900",3971,31,102,140,9,758,5011
"495",495,"G2601630574000",4255,59,71,213,17,1002,5617
"496",496,"G2601630574100",2905,38,29,143,12,180,3307
"497",497,"G2601630574200",2076,153,159,74,4,57,2523
"498",498,"G2601630574300",1950,116,72,140,14,220,2512
"499",499,"G2601630574400",671,47,37,26,1,23,805
"500",500,"G2601630574500",2994,5,26,65,5,62,3157
"501",501,"G2601630574600",4651,17,34,157,8,34,4901
"502",502,"G2601630574700",4103,23,50,156,6,50,4388
"503",503,"G2601630574800",4187,9,47,82,4,60,4389
"504",504,"G2601630574900",1622,85,41,54,5,24,1831
"505",505,"G2601630575000",4335,9,48,161,12,61,4626
"506",506,"G2601630575100",2661,9,43,74,13,19,2819
"507",507,"G2601630575200",4063,142,75,151,23,57,4511
"508",508,"G2601630575300",3635,5,17,89,13,29,3788
"509",509,"G2601630575400",3176,7,46,145,7,35,3416
"510",510,"G2601630575500",3824,44,59,154,6,47,4134
"511",511,"G2601630575600",1523,20,39,34,2,34,1652
"512",512,"G2601630576000",1615,90,44,139,12,34,1934
"513",513,"G2601630576100",5680,29,63,406,17,76,6271
"514",514,"G2601630576200",2598,3,12,100,9,15,2737
"515",515,"G2601630576300",2273,6,13,136,13,19,2460
"516",516,"G2601630576400",3774,37,25,105,6,20,3967
"517",517,"G2601630576500",3821,10,16,170,14,24,4055
"518",518,"G2601630576600",4110,5,25,175,8,53,4376
"519",519,"G2601630576700",3303,31,41,158,15,28,3576
"520",520,"G2601630577000",3255,481,38,347,31,90,4242
"521",521,"G2601630577100",2649,74,28,318,35,54,3158
"522",522,"G2601630577200",3137,49,36,293,22,77,3614
"523",523,"G2601630577300",3080,37,10,200,13,60,3400
"524",524,"G2601630577400",3369,21,16,289,8,40,3743
"525",525,"G2601630577500",3255,21,10,206,14,30,3536
"526",526,"G2601630577600",3739,18,17,180,18,52,4024
"527",527,"G2601630577700",2254,5,18,107,5,17,2406
"528",528,"G2601630577800",4664,33,9,276,11,49,5042
"529",529,"G2601630577900",3868,30,5,179,12,50,4144
"530",530,"G2601630578000",2431,41,13,161,4,49,2699
"531",531,"G2601630578500",4300,55,55,500,26,92,5028
"532",532,"G2601630578600",4473,501,86,455,43,149,5707
"533",533,"G2601630579000",0,0,0,0,0,0,0
"534",534,"G2601630579100",1960,519,2,189,28,79,2777
"535",535,"G2601630579200",2958,638,14,281,30,138,4059
"536",536,"G2601630579300",33,2987,2,22,4,33,3081
"537",537,"G2601630579500",1611,261,1,136,23,71,2103
"538",538,"G2601630579600",55,3585,0,41,4,47,3732
"539",539,"G2601630579700",2128,475,18,609,14,108,3352
"540",540,"G2601630579800",1519,212,4,218,17,72,2042
"541",541,"G2601630580100",2288,32,5,88,7,43,2463
"542",542,"G2601630580200",3051,10,8,89,18,47,3223
"543",543,"G2601630580300",2744,4,2,136,11,37,2934
"544",544,"G2601630580400",2629,2,25,66,3,18,2743
"545",545,"G2601630580500",2964,7,5,71,12,25,3084
"546",546,"G2601630580600",3151,15,7,99,18,44,3334
"547",547,"G2601630580700",3846,20,19,127,20,80,4112
"548",548,"G2601630580800",1665,9,8,43,10,50,1785
"549",549,"G2601630580900",4083,45,18,97,22,63,4328
"550",550,"G2601630581100",3384,181,108,243,26,55,3997
"551",551,"G2601630581200",3198,88,160,96,20,26,3588
"552",552,"G2601630581500",2282,3,13,71,9,17,2395
"553",553,"G2601630581600",4474,111,61,198,29,40,4913
"554",554,"G2601630581800",2775,10,5,110,12,31,2943
"555",555,"G2601630581900",4609,8,20,217,10,46,4910
"556",556,"G2601630582000",2617,201,109,134,13,41,3115
"557",557,"G2601630582100",4043,22,34,129,12,35,4275
"558",558,"G2601630583000",2651,11,37,100,18,47,2864
"559",559,"G2601630583100",4214,46,10,137,29,35,4471
"560",560,"G2601630583200",2965,19,13,105,31,52,3185
"561",561,"G2601630583300",2622,17,29,70,26,32,2796
"562",562,"G2601630583400",5027,31,25,174,32,59,5348
"563",563,"G2601630583500",2835,22,18,71,18,33,2997
"564",564,"G2601630583600",2623,23,26,127,21,30,2850
"565",565,"G2601630583700",3382,55,16,105,11,26,3595
"566",566,"G2601630583800",4210,131,88,137,37,55,4658
"567",567,"G2601630583900",3126,505,157,102,9,61,3960
"568",568,"G2601630584000",3516,669,91,142,29,121,4568
"569",569,"G2601630584100",1879,24,7,76,15,28,2029
"570",570,"G2601630584200",2776,455,71,134,27,92,3555
"571",571,"G2601630584300",1586,121,84,67,19,38,1915
"572",572,"G2601630584400",2720,76,94,113,24,57,3084
"573",573,"G2601630584500",1900,164,28,90,12,31,2225
"574",574,"G2601630584600",1532,280,142,59,9,60,2082
"575",575,"G2601630584700",2595,83,90,86,14,57,2925
"576",576,"G2601630584800",3179,2989,57,236,22,278,6761
"577",577,"G2601630585500",2178,129,8,42,21,65,2443
"578",578,"G2601630585600",448,1741,13,49,11,102,2364
"579",579,"G2601630585700",1236,731,3,44,9,55,2078
"580",580,"G2601630585800",2202,1588,14,68,16,111,3999
"581",581,"G2601630585900",2301,939,19,41,27,45,3372
"582",582,"G2601630586000",14,3,0,0,1,0,18
"583",583,"G2601630586200",4426,1684,86,183,26,204,6609
"584",584,"G2601630586300",1968,39,10,36,7,36,2096
"585",585,"G2601630587000",3453,314,45,101,13,76,4002
"586",586,"G2601630587900",2842,729,41,86,27,113,3838
"587",587,"G2601630588000",4083,739,234,120,28,119,5323
"588",588,"G2601630588100",2241,125,6,52,18,41,2483
"589",589,"G2601630588200",2336,741,114,125,10,102,3428
"590",590,"G2601630588300",4394,227,18,115,24,73,4851
"591",591,"G2601630588400",3234,259,34,31,8,65,3631
"592",592,"G2601630589300",3672,608,4,72,32,93,4481
"593",593,"G2601630589400",6223,848,17,139,23,125,7375
"594",594,"G2601630590400",5753,76,16,148,27,71,6091
"595",595,"G2601630590500",5611,57,21,156,42,80,5967
"596",596,"G2601630590600",1594,7,10,40,7,21,1679
"597",597,"G2601630591500",4669,441,425,191,22,118,5866
"598",598,"G2601630591600",978,63,11,30,8,22,1112
"599",599,"G2601630591700",4155,97,176,199,12,76,4715
"600",600,"G2601630591800",3711,198,208,216,21,118,4472
"601",601,"G2601630591900",4574,59,55,135,16,53,4892
"602",602,"G2601630592000",1828,9,4,53,20,18,1932
"603",603,"G2601630593000",4753,135,79,126,27,78,5198
"604",604,"G2601630593200",3512,89,75,175,11,57,3919
"605",605,"G2601630593300",3116,68,49,132,19,29,3413
"606",606,"G2601630594000",2636,7,38,82,15,50,2828
"607",607,"G2601630594100",4363,8,28,73,13,33,4518
"608",608,"G2601630594200",2635,2,27,50,6,20,2740
"609",609,"G2601630594300",3346,1,15,72,17,29,3480
"610",610,"G2601630594400",2445,12,13,58,16,32,2576
"611",611,"G2601630594500",3263,43,33,55,11,37,3442
"612",612,"G2601630595000",4046,30,27,91,25,42,4261
"613",613,"G2601630595100",5278,182,158,151,12,68,5849
"614",614,"G2601630595200",2903,63,65,85,16,30,3162
"615",615,"G2601630596100",3746,16,96,60,5,21,3944
"616",616,"G2601630596200",4113,15,144,68,13,58,4411
"617",617,"G2601630596300",2382,8,58,47,17,27,2539
"618",618,"G2601630597000",4078,22,17,78,13,56,4264
"619",619,"G2601630598000",3233,22,21,87,34,45,3442
"620",620,"G2601630599000",3559,102,10,91,18,59,3839
"621",621,"G2601630599100",4368,17,30,138,17,79,4649
